Importers,Year,Knitted_Crocheted,Not_Knitted_Crocheted,Other_Articles,Apparel_Imports
Afghanistan,2005,0,0,0,0
Afghanistan,2006,0,0,0,0
Afghanistan,2007,0,0,0,0
Afghanistan,2008,6541,3186,13393,23120
Afghanistan,2009,6523,5182,10638,22343
Afghanistan,2010,10285,12036,20015,42336
Afghanistan,2011,11606,6479,8092,26177
Afghanistan,2012,43944,19768,21119,84831
Afghanistan,2013,57186,17756,38936,113878
Afghanistan,2014,27249,13458,19851,60558
Afghanistan,2015,25132,11308,7686,44126
Afghanistan,2016,30336,10620,8740,49696
Afghanistan,2017,14838,14942,19055,48835
Afghanistan,2018,18793,12456,11399,42648
Afghanistan,2019,13853,12350,8283,34486
Afghanistan,2020,77582,127791,66866,272239
Afghanistan,2021,61083,91369,54227,206679
Afghanistan,2022,31726,55166,54203,141095
Afghanistan,2023,53652,79537,55716,188905
Afghanistan,2024,0,0,0,0
Albania,2005,71095,74614,17639,163348
Albania,2006,85015,85211,17878,188104
Albania,2007,119597,107977,19344,246918
Albania,2008,126448,116075,23686,266209
Albania,2009,97031,81441,22326,200798
Albania,2010,97445,72853,21532,191830
Albania,2011,113582,81609,21152,216343
Albania,2012,94902,77411,18093,190406
Albania,2013,104574,93473,20030,218077
Albania,2014,117946,114990,21706,254642
Albania,2015,99616,108062,19948,227626
Albania,2016,134478,132684,23881,291043
Albania,2017,145175,139786,26666,311627
Albania,2018,160696,149598,30724,341018
Albania,2019,161719,147349,29714,338782
Albania,2020,140825,115681,34785,291291
Albania,2021,190285,149944,36533,376762
Albania,2022,185647,148457,35509,369613
Albania,2023,164238,157285,41327,362850
Albania,2024,0,0,0,0
Algeria,2005,40177,33988,25805,99970
Algeria,2006,43109,35352,30317,108778
Algeria,2007,44139,43092,44609,131840
Algeria,2008,52888,54234,51256,158378
Algeria,2009,60392,66738,69197,196327
Algeria,2010,72053,88329,64689,225071
Algeria,2011,85931,128911,72034,286876
Algeria,2012,110958,148184,80567,339709
Algeria,2013,122339,181477,99881,403697
Algeria,2014,153701,223305,117921,494927
Algeria,2015,144973,244458,116493,505924
Algeria,2016,169249,275546,117901,562696
Algeria,2017,195861,285090,120791,601742
Algeria,2018,394211,387156,159885,941252
Algeria,2019,420943,388589,160239,969771
Algeria,2020,316711,288967,169978,775656
Algeria,2021,367424,346496,140480,854400
Algeria,2022,328348,306913,72072,707333
Algeria,2023,485498,376881,97558,959937
Algeria,2024,0,0,0,0
American Samoa,2005,0,0,0,0
American Samoa,2006,0,0,0,0
American Samoa,2007,0,0,0,0
American Samoa,2008,0,0,0,0
American Samoa,2009,0,0,0,0
American Samoa,2010,0,0,0,0
American Samoa,2011,0,0,0,0
American Samoa,2012,0,0,7,7
American Samoa,2013,0,4,27,31
American Samoa,2014,16,2,1,19
American Samoa,2015,216,292,49,557
American Samoa,2016,228,368,70,666
American Samoa,2017,133,403,26,562
American Samoa,2018,112,332,13,457
American Samoa,2019,54,530,5,589
American Samoa,2020,59,405,23,487
American Samoa,2021,91,362,2,455
American Samoa,2022,69,387,15,471
American Samoa,2023,545,1278,331,2154
American Samoa,2024,0,0,0,0
Andorra,2005,0,0,0,0
Andorra,2006,46778,98722,10054,155554
Andorra,2007,50782,114194,8968,173944
Andorra,2008,49068,115724,10546,175338
Andorra,2009,45818,99295,15197,160310
Andorra,2010,44412,95863,11969,152244
Andorra,2011,44370,100484,10445,155299
Andorra,2012,37804,84547,7564,129915
Andorra,2013,40727,82518,7735,130980
Andorra,2014,42671,85644,8214,136529
Andorra,2015,38784,65597,7808,112189
Andorra,2016,34877,68390,8964,112231
Andorra,2017,38488,72741,8323,119552
Andorra,2018,39237,72868,9702,121807
Andorra,2019,34397,69335,9232,112964
Andorra,2020,28073,47230,11151,86454
Andorra,2021,37859,51551,9666,99076
Andorra,2022,51269,54161,9819,115249
Andorra,2023,54148,55200,9342,118690
Andorra,2024,0,0,0,0
Angola,2005,24784,34457,81625,140866
Angola,2006,34818,49209,102115,186142
Angola,2007,32889,58686,94642,186217
Angola,2008,76140,94566,162755,333461
Angola,2009,62852,97968,202465,363285
Angola,2010,44583,69294,116809,230686
Angola,2011,56041,75520,138728,270289
Angola,2012,88759,115922,198759,403440
Angola,2013,66968,94513,168220,329701
Angola,2014,83844,106091,257676,447611
Angola,2015,39368,48063,74344,161775
Angola,2016,40319,42471,72352,155142
Angola,2017,95260,49205,164791,309256
Angola,2018,40359,50383,127942,218684
Angola,2019,52737,48443,108962,210142
Angola,2020,21702,25269,98984,145955
Angola,2021,21520,25162,265413,312095
Angola,2022,60473,46670,202433,309576
Angola,2023,41146,46778,142952,230876
Angola,2024,0,0,0,0
Anguilla,2005,274,783,241,1298
Anguilla,2006,113,539,532,1184
Anguilla,2007,83,367,334,784
Anguilla,2008,89,355,308,752
Anguilla,2009,202,476,645,1323
Anguilla,2010,175,560,470,1205
Anguilla,2011,223,447,321,991
Anguilla,2012,280,823,227,1330
Anguilla,2013,171,584,406,1161
Anguilla,2014,257,638,460,1355
Anguilla,2015,175,587,572,1334
Anguilla,2016,191,488,413,1092
Anguilla,2017,64,140,224,428
Anguilla,2018,366,454,967,1787
Anguilla,2019,136,670,763,1569
Anguilla,2020,43,86,306,435
Anguilla,2021,110,675,1235,2020
Anguilla,2022,264,763,1575,2602
Anguilla,2023,198,489,918,1605
Anguilla,2024,0,0,0,0
Antigua and Barbuda,2005,2326,3554,5992,11872
Antigua and Barbuda,2006,0,0,0,0
Antigua and Barbuda,2007,6824,7703,9787,24314
Antigua and Barbuda,2008,0,0,0,0
Antigua and Barbuda,2009,3226,5617,8858,17701
Antigua and Barbuda,2010,2464,4625,10260,17349
Antigua and Barbuda,2011,2667,4374,6377,13418
Antigua and Barbuda,2012,2467,5266,7687,15420
Antigua and Barbuda,2013,2778,4570,9660,17008
Antigua and Barbuda,2014,2972,5152,7946,16070
Antigua and Barbuda,2015,3129,5492,8121,16742
Antigua and Barbuda,2016,2754,4958,9078,16790
Antigua and Barbuda,2017,2450,6545,11638,20633
Antigua and Barbuda,2018,3006,7104,4176,14286
Antigua and Barbuda,2019,2713,6327,4388,13428
Antigua and Barbuda,2020,1410,4256,2743,8409
Antigua and Barbuda,2021,1662,4155,5870,11687
Antigua and Barbuda,2022,3018,5970,4909,13897
Antigua and Barbuda,2023,2698,6208,5350,14256
Antigua and Barbuda,2024,0,0,0,0
Argentina,2005,45787,76752,68290,190829
Argentina,2006,54404,98075,84572,237051
Argentina,2007,83637,134083,112896,330616
Argentina,2008,141530,206797,137743,486070
Argentina,2009,114143,166228,102489,382860
Argentina,2010,133226,194523,119383,447132
Argentina,2011,195936,273514,141323,610773
Argentina,2012,148983,228968,87384,465335
Argentina,2013,120907,205847,93742,420496
Argentina,2014,105404,176108,68565,350077
Argentina,2015,96091,184539,62764,343394
Argentina,2016,131200,232430,88591,452221
Argentina,2017,180367,283674,98217,562258
Argentina,2018,221840,294952,106332,623124
Argentina,2019,174456,185413,73696,433565
Argentina,2020,112406,121288,187636,421330
Argentina,2021,97312,107871,111625,316808
Argentina,2022,123070,153441,100512,377023
Argentina,2023,162105,207776,77586,447467
Argentina,2024,160139,185084,77937,423160
Armenia,2005,6385,15949,8575,30909
Armenia,2006,8454,21873,9228,39555
Armenia,2007,9415,21668,10717,41800
Armenia,2008,19290,42334,44756,106380
Armenia,2009,16985,30248,11164,58397
Armenia,2010,21824,40350,13503,75677
Armenia,2011,24269,48489,16902,89660
Armenia,2012,27699,43256,14979,85934
Armenia,2013,30305,43494,12125,85924
Armenia,2014,30793,44438,16437,91668
Armenia,2015,30801,44822,7518,83141
Armenia,2016,42079,59219,12486,113784
Armenia,2017,53940,76849,15161,145950
Armenia,2018,84653,96430,13971,195054
Armenia,2019,87176,69439,15754,172369
Armenia,2020,67966,59684,16431,144081
Armenia,2021,70640,79611,25824,176075
Armenia,2022,87768,107361,20949,216078
Armenia,2023,151085,198625,40022,389732
Armenia,2024,173156,194276,48956,416388
Aruba,2005,36494,6995,36,43525
Aruba,2006,36007,8503,33,44543
Aruba,2007,40257,7884,52,48193
Aruba,2008,30927,7172,67,38166
Aruba,2009,12153,28148,7719,48020
Aruba,2010,12275,26253,7286,45814
Aruba,2011,16361,25260,8442,50063
Aruba,2012,16510,25329,7770,49609
Aruba,2013,15974,27188,9689,52851
Aruba,2014,15237,31569,11151,57957
Aruba,2015,17306,29678,11125,58109
Aruba,2016,17832,26378,8339,52549
Aruba,2017,14498,31054,9145,54697
Aruba,2018,14082,31727,9062,54871
Aruba,2019,14861,29618,10248,54727
Aruba,2020,9200,16998,9240,35438
Aruba,2021,14814,22189,9719,46722
Aruba,2022,20607,31330,13301,65238
Aruba,2023,20468,33650,12452,66570
Aruba,2024,0,0,0,0
Australia,2005,1392355,1618803,591651,3602809
Australia,2006,1488261,1679928,662018,3830207
Australia,2007,1761378,1849838,780154,4391370
Australia,2008,1965306,2126787,883016,4975109
Australia,2009,1863703,1998548,774943,4637194
Australia,2010,2299586,2476448,979867,5755901
Australia,2011,2566880,2787472,1092909,6447261
Australia,2012,2683771,2923602,1176925,6784298
Australia,2013,2837121,2976460,1204797,7018378
Australia,2014,2957107,3078361,1269942,7305410
Australia,2015,3066028,3074490,1309286,7449804
Australia,2016,2966389,2959841,1296498,7222728
Australia,2017,3093020,3111032,1359345,7563397
Australia,2018,3213770,3347006,1463560,8024336
Australia,2019,3226342,3372127,1384875,7983344
Australia,2020,2990087,3320593,2720578,9031258
Australia,2021,3897300,3494607,2011008,9402915
Australia,2022,4218161,4039360,2135045,10392566
Australia,2023,3774225,3763880,1559087,9097192
Australia,2024,4020997,3868819,1688865,9578681
Austria,2005,1760167,2211154,418899,4390220
Austria,2006,1887661,2320413,425112,4633186
Austria,2007,2170793,2700996,489440,5361229
Austria,2008,2392518,2949471,551000,5892989
Austria,2009,2166359,2555011,490952,5212322
Austria,2010,2307729,2614204,516532,5438465
Austria,2011,2687463,3057059,604305,6348827
Austria,2012,2454558,2750594,521319,5726471
Austria,2013,2675257,2838521,606118,6119896
Austria,2014,2926347,2989750,684090,6600187
Austria,2015,2635393,2664465,592989,5892847
Austria,2016,2933383,2851853,635548,6420784
Austria,2017,3279431,3107629,674192,7061252
Austria,2018,3392635,3395173,702349,7490157
Austria,2019,3355160,3328518,699908,7383586
Austria,2020,3086871,3091474,1398742,7577087
Austria,2021,3567193,3231598,974131,7772922
Austria,2022,3663430,3271492,821584,7756506
Austria,2023,3218289,3177719,697313,7093321
Austria,2024,3764573,4006034,788637,8559244
Azerbaijan,2005,3294,32921,9023,45238
Azerbaijan,2006,2756,23826,7239,33821
Azerbaijan,2007,2571,19153,9084,30808
Azerbaijan,2008,1874,21624,7609,31107
Azerbaijan,2009,2093,22319,7472,31884
Azerbaijan,2010,2780,23066,10014,35860
Azerbaijan,2011,4784,28050,11227,44061
Azerbaijan,2012,5886,29828,8243,43957
Azerbaijan,2013,7155,32740,15473,55368
Azerbaijan,2014,13593,40039,7655,61287
Azerbaijan,2015,6173,39312,9395,54880
Azerbaijan,2016,106657,104881,25839,237377
Azerbaijan,2017,98929,96386,29016,224331
Azerbaijan,2018,153590,118543,36049,308182
Azerbaijan,2019,153439,123521,33856,310816
Azerbaijan,2020,114505,91816,57369,263690
Azerbaijan,2021,164460,97440,49062,310962
Azerbaijan,2022,167546,123104,40358,331008
Azerbaijan,2023,237116,177905,50790,465811
Azerbaijan,2024,236581,180398,56988,473967
Bahamas,2005,21182,24906,14317,60405
Bahamas,2006,17932,23058,15412,56402
Bahamas,2007,16656,24189,21065,61910
Bahamas,2008,15296,21345,15319,51960
Bahamas,2009,13960,20812,13800,48572
Bahamas,2010,15137,22966,16223,54326
Bahamas,2011,16135,25785,17425,59345
Bahamas,2012,18771,27698,18640,65109
Bahamas,2013,15953,24803,18912,59668
Bahamas,2014,15670,24918,20372,60960
Bahamas,2015,15480,31159,24798,71437
Bahamas,2016,14384,28939,20130,63453
Bahamas,2017,17245,34770,25229,77244
Bahamas,2018,22519,51236,26738,100493
Bahamas,2019,13796,31732,22544,68072
Bahamas,2020,9878,19236,13154,42268
Bahamas,2021,11309,32834,24196,68339
Bahamas,2022,15735,42856,27123,85714
Bahamas,2023,20882,51617,30769,103268
Bahamas,2024,0,0,0,0
Bahrain,2005,32247,37319,9238,78804
Bahrain,2006,19410,24064,6703,50177
Bahrain,2007,28566,40567,9739,78872
Bahrain,2008,71137,87250,15636,174023
Bahrain,2009,32463,46512,11784,90759
Bahrain,2010,56629,56833,14182,127644
Bahrain,2011,64147,63573,15230,142950
Bahrain,2012,64716,70528,18278,153522
Bahrain,2013,81682,83637,18839,184158
Bahrain,2014,136417,123392,23939,283748
Bahrain,2015,135832,141801,26545,304178
Bahrain,2016,147933,143320,24436,315689
Bahrain,2017,160221,179088,26048,365357
Bahrain,2018,146656,169697,27730,344083
Bahrain,2019,129039,144454,26189,299682
Bahrain,2020,90632,143374,73076,307082
Bahrain,2021,113749,109466,30922,254137
Bahrain,2022,147704,135425,29046,312175
Bahrain,2023,152856,143317,28463,324636
Bahrain,2024,0,0,0,0
Bangladesh,2005,15076,226206,10057,251339
Bangladesh,2006,5126,156309,5122,166557
Bangladesh,2007,4572,185082,10000,199654
Bangladesh,2008,8801,519901,17492,546194
Bangladesh,2009,9000,488084,15538,512622
Bangladesh,2010,12469,587759,21054,621282
Bangladesh,2011,20071,627404,33080,680555
Bangladesh,2012,16988,682604,40384,739976
Bangladesh,2013,11672,707366,28181,747219
Bangladesh,2014,0,0,0,0
Bangladesh,2015,22897,887052,34159,944108
Bangladesh,2016,91825,240232,59980,392037
Bangladesh,2017,73830,186711,64914,325455
Bangladesh,2018,57786,172597,67780,298163
Bangladesh,2019,46734,164939,76208,287881
Bangladesh,2020,45736,167512,105707,318955
Bangladesh,2021,70607,182247,78985,331839
Bangladesh,2022,81133,201623,81204,363960
Bangladesh,2023,85048,148404,59525,292977
Bangladesh,2024,0,0,0,0
Barbados,2005,7948,16275,8692,32915
Barbados,2006,5496,14860,8533,28889
Barbados,2007,5154,10877,9413,25444
Barbados,2008,5185,15665,10439,31289
Barbados,2009,4834,13132,8655,26621
Barbados,2010,5102,13986,8860,27948
Barbados,2011,6009,15989,9454,31452
Barbados,2012,5539,15295,8764,29598
Barbados,2013,6251,14867,9971,31089
Barbados,2014,6048,15379,9860,31287
Barbados,2015,5968,15649,9970,31587
Barbados,2016,5740,16003,9954,31697
Barbados,2017,5743,15449,9924,31116
Barbados,2018,5851,15732,10560,32143
Barbados,2019,5176,10794,9293,25263
Barbados,2020,3533,10696,11561,25790
Barbados,2021,3385,10965,11877,26227
Barbados,2022,4402,11389,14950,30741
Barbados,2023,6093,11582,12866,30541
Barbados,2024,5875,11226,14207,31308
Belarus,2005,20653,30689,45271,96613
Belarus,2006,23234,34269,29111,86614
Belarus,2007,33976,42781,26434,103191
Belarus,2008,47296,60328,44182,151806
Belarus,2009,42064,50493,36526,129083
Belarus,2010,59556,57117,43985,160658
Belarus,2011,77571,68227,44319,190117
Belarus,2012,88309,87478,53177,228964
Belarus,2013,119918,143074,62710,325702
Belarus,2014,151714,201166,67735,420615
Belarus,2015,99424,132100,49086,280610
Belarus,2016,121973,126970,115674,364617
Belarus,2017,202654,161724,127214,491592
Belarus,2018,241367,188653,167590,597610
Belarus,2019,237204,218046,204249,659499
Belarus,2020,164875,157720,195059,517654
Belarus,2021,217856,197549,175101,590506
Belarus,2022,82068,73020,130568,285656
Belarus,2023,119202,83289,183395,385886
Belarus,2024,0,0,0,0
Belgium,2005,3281048,4125111,765662,8171821
Belgium,2006,3580543,4284745,873154,8738442
Belgium,2007,4087384,4638377,1023274,9749035
Belgium,2008,4656183,5179507,1106738,10942428
Belgium,2009,4197570,4470350,991196,9659116
Belgium,2010,4118247,4051129,1042478,9211854
Belgium,2011,4638553,4561652,1234667,10434872
Belgium,2012,4291809,4101638,1097553,9491000
Belgium,2013,4570504,4336736,1177903,10085143
Belgium,2014,4814478,4526234,1269209,10609921
Belgium,2015,4260154,3765819,1011195,9037168
Belgium,2016,4530958,3845254,1085533,9461745
Belgium,2017,4729538,3873795,1087045,9690378
Belgium,2018,5157957,4217692,1153390,10529039
Belgium,2019,5021117,4166823,1096460,10284400
Belgium,2020,4554668,3751366,2051118,10357152
Belgium,2021,5234143,3764844,1327316,10326303
Belgium,2022,5743070,3984965,1273472,11001507
Belgium,2023,4718112,3679078,1161083,9558273
Belgium,2024,2320592,2082945,729838,5133375
Belize,2005,977,2285,2286,5548
Belize,2006,963,5574,3034,9571
Belize,2007,902,2445,3120,6467
Belize,2008,1022,4084,2913,8019
Belize,2009,796,2490,2759,6045
Belize,2010,652,2622,3073,6347
Belize,2011,1644,3499,3417,8560
Belize,2012,1198,3231,4744,9173
Belize,2013,1601,3078,6361,11040
Belize,2014,25785,26822,9271,61878
Belize,2015,22776,31792,8929,63497
Belize,2016,21362,27058,9221,57641
Belize,2017,25489,24413,8731,58633
Belize,2018,27424,24539,9839,61802
Belize,2019,31050,21836,9645,62531
Belize,2020,13974,9569,8876,32419
Belize,2021,23041,13504,12834,49379
Belize,2022,39431,20933,15669,76033
Belize,2023,35791,14777,12177,62745
Belize,2024,36596,13011,13175,62782
Benin,2005,12311,9048,39716,61075
Benin,2006,15869,20034,47834,83737
Benin,2007,16836,29320,63333,109489
Benin,2008,24633,31040,62259,117932
Benin,2009,20727,30031,57155,107913
Benin,2010,17682,26177,56949,100808
Benin,2011,6220,14619,67542,88381
Benin,2012,4092,5679,58726,68497
Benin,2013,5490,3724,58978,68192
Benin,2014,3717,3610,87820,95147
Benin,2015,2940,1847,55438,60225
Benin,2016,1963,1540,25001,28504
Benin,2017,1695,1283,19847,22825
Benin,2018,2302,1035,36443,39780
Benin,2019,1147,1081,46059,48287
Benin,2020,1003,2097,51741,54841
Benin,2021,1546,2582,46835,50963
Benin,2022,1561,1605,66603,69769
Benin,2023,1719,1989,75250,78958
Benin,2024,1692,1713,58646,62051
Bermuda,2005,0,0,0,0
Bermuda,2006,0,0,0,0
Bermuda,2007,0,0,0,0
Bermuda,2008,0,0,0,0
Bermuda,2009,0,0,0,0
Bermuda,2010,0,0,0,0
Bermuda,2011,0,0,0,0
Bermuda,2012,10730,14196,5769,30695
Bermuda,2013,12471,14909,6033,33413
Bermuda,2014,12074,14494,6557,33125
Bermuda,2015,11473,14983,6421,32877
Bermuda,2016,11687,14834,6075,32596
Bermuda,2017,12369,14739,7445,34553
Bermuda,2018,11049,14875,6600,32524
Bermuda,2019,10102,13354,7197,30653
Bermuda,2020,6846,10238,13131,30215
Bermuda,2021,8123,16071,9418,33612
Bermuda,2022,9566,18797,9952,38315
Bermuda,2023,10877,20366,9663,40906
Bermuda,2024,0,0,0,0
Bhutan,2005,468,1069,544,2081
Bhutan,2006,432,909,1500,2841
Bhutan,2007,362,824,989,2175
Bhutan,2008,501,987,1611,3099
Bhutan,2009,407,739,1259,2405
Bhutan,2010,650,1124,3111,4885
Bhutan,2011,1145,1304,2373,4822
Bhutan,2012,1232,1445,2378,5055
Bhutan,2013,0,0,0,0
Bhutan,2014,0,0,0,0
Bhutan,2015,0,0,0,0
Bhutan,2016,1423,2472,2672,6567
Bhutan,2017,1807,2638,2512,6957
Bhutan,2018,1855,2052,3052,6959
Bhutan,2019,1505,1852,2895,6252
Bhutan,2020,2667,2680,4506,9853
Bhutan,2021,7016,6008,6227,19251
Bhutan,2022,9222,11138,5523,25883
Bhutan,2023,4364,4696,3736,12796
Bhutan,2024,0,0,0,0
"Bolivia, Plurinational State of",2005,6527,7751,7558,21836
"Bolivia, Plurinational State of",2006,7886,8598,10054,26538
"Bolivia, Plurinational State of",2007,10314,11457,10502,32273
"Bolivia, Plurinational State of",2008,12983,11928,11078,35989
"Bolivia, Plurinational State of",2009,11086,10458,9269,30813
"Bolivia, Plurinational State of",2010,19902,17038,15100,52040
"Bolivia, Plurinational State of",2011,28515,27103,20361,75979
"Bolivia, Plurinational State of",2012,36731,33994,21239,91964
"Bolivia, Plurinational State of",2013,33963,33266,19907,87136
"Bolivia, Plurinational State of",2014,32827,32096,20500,85423
"Bolivia, Plurinational State of",2015,32391,31249,18819,82459
"Bolivia, Plurinational State of",2016,26796,26828,13893,67517
"Bolivia, Plurinational State of",2017,24935,20749,10211,55895
"Bolivia, Plurinational State of",2018,22858,20311,10378,53547
"Bolivia, Plurinational State of",2019,21654,18857,10810,51321
"Bolivia, Plurinational State of",2020,14735,12589,67161,94485
"Bolivia, Plurinational State of",2021,20763,15691,24367,60821
"Bolivia, Plurinational State of",2022,24863,19681,18133,62677
"Bolivia, Plurinational State of",2023,25503,18387,9166,53056
"Bolivia, Plurinational State of",2024,20553,14196,6445,41194
"Bonaire, Sint Eustatius and Saba",2005,0,0,0,0
"Bonaire, Sint Eustatius and Saba",2006,0,0,0,0
"Bonaire, Sint Eustatius and Saba",2007,0,0,0,0
"Bonaire, Sint Eustatius and Saba",2008,0,0,0,0
"Bonaire, Sint Eustatius and Saba",2009,0,0,0,0
"Bonaire, Sint Eustatius and Saba",2010,0,0,0,0
"Bonaire, Sint Eustatius and Saba",2011,38,0,0,38
"Bonaire, Sint Eustatius and Saba",2012,20,10,21,51
"Bonaire, Sint Eustatius and Saba",2013,363,252,172,787
"Bonaire, Sint Eustatius and Saba",2014,217,364,250,831
"Bonaire, Sint Eustatius and Saba",2015,285,392,832,1509
"Bonaire, Sint Eustatius and Saba",2016,139,446,941,1526
"Bonaire, Sint Eustatius and Saba",2017,126,474,783,1383
"Bonaire, Sint Eustatius and Saba",2018,264,521,798,1583
"Bonaire, Sint Eustatius and Saba",2019,291,649,896,1836
"Bonaire, Sint Eustatius and Saba",2020,235,983,741,1959
"Bonaire, Sint Eustatius and Saba",2021,183,1335,769,2287
"Bonaire, Sint Eustatius and Saba",2022,406,1677,1377,3460
"Bonaire, Sint Eustatius and Saba",2023,978,1843,1458,4279
"Bonaire, Sint Eustatius and Saba",2024,0,0,0,0
Bosnia and Herzegovina,2005,53487,105750,19682,178919
Bosnia and Herzegovina,2006,56074,96792,22440,175306
Bosnia and Herzegovina,2007,73388,103892,30201,207481
Bosnia and Herzegovina,2008,87727,119833,35678,243238
Bosnia and Herzegovina,2009,71803,94114,27662,193579
Bosnia and Herzegovina,2010,73168,91177,28682,193027
Bosnia and Herzegovina,2011,83222,98213,29062,210497
Bosnia and Herzegovina,2012,75382,93259,28558,197199
Bosnia and Herzegovina,2013,88516,96159,28191,212866
Bosnia and Herzegovina,2014,96529,117304,40431,254264
Bosnia and Herzegovina,2015,80532,100128,29222,209882
Bosnia and Herzegovina,2016,95542,113882,32646,242070
Bosnia and Herzegovina,2017,93921,132881,38905,265707
Bosnia and Herzegovina,2018,116237,141250,43558,301045
Bosnia and Herzegovina,2019,138357,141096,43039,322492
Bosnia and Herzegovina,2020,149422,114778,52547,316747
Bosnia and Herzegovina,2021,205783,146676,56118,408577
Bosnia and Herzegovina,2022,233884,163579,54163,451626
Bosnia and Herzegovina,2023,256801,173730,51133,481664
Bosnia and Herzegovina,2024,291343,181619,57805,530767
Botswana,2005,30700,40511,16068,87279
Botswana,2006,32543,40708,14407,87658
Botswana,2007,40928,49588,20249,110765
Botswana,2008,43472,59245,19879,122596
Botswana,2009,46303,63613,19760,129676
Botswana,2010,55157,59252,20426,134835
Botswana,2011,68295,62545,28877,159717
Botswana,2012,65645,64716,36603,166964
Botswana,2013,51771,52341,25475,129587
Botswana,2014,59019,48141,27635,134795
Botswana,2015,53722,45215,25010,123947
Botswana,2016,45118,43637,22013,110768
Botswana,2017,46305,28857,18050,93212
Botswana,2018,46730,33273,25145,105148
Botswana,2019,35782,25852,24291,85925
Botswana,2020,25744,21255,25250,72249
Botswana,2021,37242,31785,32122,101149
Botswana,2022,40501,37214,31294,109009
Botswana,2023,38588,36483,30972,106043
Botswana,2024,42658,43912,32915,119485
Bouvet Island,2005,0,0,0,0
Bouvet Island,2006,0,0,0,0
Bouvet Island,2007,0,0,0,0
Bouvet Island,2008,0,0,0,0
Bouvet Island,2009,0,0,0,0
Bouvet Island,2010,0,0,0,0
Bouvet Island,2011,0,0,0,0
Bouvet Island,2012,0,0,0,0
Bouvet Island,2013,0,0,0,0
Bouvet Island,2014,0,0,0,0
Bouvet Island,2015,0,0,0,0
Bouvet Island,2016,0,0,0,0
Bouvet Island,2017,0,0,0,0
Bouvet Island,2018,0,0,0,0
Bouvet Island,2019,0,0,0,0
Bouvet Island,2020,0,0,0,0
Bouvet Island,2021,0,0,0,0
Bouvet Island,2022,0,0,0,0
Bouvet Island,2023,0,3,0,3
Bouvet Island,2024,0,0,0,0
Brazil,2005,75994,167275,36147,279416
Brazil,2006,115145,245780,56800,417725
Brazil,2007,174685,332870,100294,607849
Brazil,2008,261568,471885,158360,891813
Brazil,2009,316199,481290,114267,911756
Brazil,2010,483554,652295,179049,1314898
Brazil,2011,751422,1038902,246477,2036801
Brazil,2012,967968,1290837,255333,2514138
Brazil,2013,1092677,1368848,261001,2722526
Brazil,2014,1165755,1469383,290609,2925747
Brazil,2015,1048631,1326063,230016,2604710
Brazil,2016,552842,687712,152257,1392811
Brazil,2017,712542,816764,205603,1734909
Brazil,2018,881646,912398,256969,2051013
Brazil,2019,859983,797213,243201,1900397
Brazil,2020,604384,509742,529344,1643470
Brazil,2021,625419,523069,296286,1444774
Brazil,2022,853950,761344,292540,1907834
Brazil,2023,963338,899565,266959,2129862
Brazil,2024,1070413,1049277,336801,2456491
British Indian Ocean Territory,2005,3,11,11,25
British Indian Ocean Territory,2006,0,36,47,83
British Indian Ocean Territory,2007,10,17,0,27
British Indian Ocean Territory,2008,6,0,19,25
British Indian Ocean Territory,2009,5,35,24,64
British Indian Ocean Territory,2010,305,513,98,916
British Indian Ocean Territory,2011,463,887,166,1516
British Indian Ocean Territory,2012,309,390,126,825
British Indian Ocean Territory,2013,311,706,190,1207
British Indian Ocean Territory,2014,190,347,191,728
British Indian Ocean Territory,2015,322,700,154,1176
British Indian Ocean Territory,2016,227,485,117,829
British Indian Ocean Territory,2017,219,307,127,653
British Indian Ocean Territory,2018,296,450,185,931
British Indian Ocean Territory,2019,224,295,249,768
British Indian Ocean Territory,2020,327,276,877,1480
British Indian Ocean Territory,2021,497,592,602,1691
British Indian Ocean Territory,2022,658,700,422,1780
British Indian Ocean Territory,2023,671,742,586,1999
British Indian Ocean Territory,2024,0,0,0,0
British Virgin Islands,2005,1376,1240,1734,4350
British Virgin Islands,2006,956,801,1738,3495
British Virgin Islands,2007,3195,3223,2339,8757
British Virgin Islands,2008,2979,4717,3671,11367
British Virgin Islands,2009,1562,1208,1996,4766
British Virgin Islands,2010,1928,1796,1830,5554
British Virgin Islands,2011,2635,3506,2649,8790
British Virgin Islands,2012,2384,1520,3193,7097
British Virgin Islands,2013,1594,1626,2079,5299
British Virgin Islands,2014,1142,1416,2870,5428
British Virgin Islands,2015,1093,1268,3202,5563
British Virgin Islands,2016,1059,1012,1379,3450
British Virgin Islands,2017,971,589,1724,3284
British Virgin Islands,2018,767,1071,2380,4218
British Virgin Islands,2019,811,1083,3208,5102
British Virgin Islands,2020,1066,742,3218,5026
British Virgin Islands,2021,450,896,4536,5882
British Virgin Islands,2022,1263,748,2076,4087
British Virgin Islands,2023,1963,1037,1946,4946
British Virgin Islands,2024,0,0,0,0
Brunei Darussalam,2005,17189,16883,3283,37355
Brunei Darussalam,2006,16250,15766,3642,35658
Brunei Darussalam,2007,18853,17513,4528,40894
Brunei Darussalam,2008,18654,19110,5676,43440
Brunei Darussalam,2009,13498,17771,5244,36513
Brunei Darussalam,2010,14212,21621,5344,41177
Brunei Darussalam,2011,16730,24677,10746,52153
Brunei Darussalam,2012,17681,24534,18645,60860
Brunei Darussalam,2013,20788,75226,9542,105556
Brunei Darussalam,2014,18338,26041,7860,52239
Brunei Darussalam,2015,15018,21323,7533,43874
Brunei Darussalam,2016,13307,21037,5287,39631
Brunei Darussalam,2017,17234,18534,7697,43465
Brunei Darussalam,2018,12536,17056,7612,37204
Brunei Darussalam,2019,14465,15515,5976,35956
Brunei Darussalam,2020,14102,17898,13294,45294
Brunei Darussalam,2021,23954,27008,17754,68716
Brunei Darussalam,2022,22167,40241,12774,75182
Brunei Darussalam,2023,16502,23270,7261,47033
Brunei Darussalam,2024,9872,35947,3689,49508
Bulgaria,2005,271840,170153,22274,464267
Bulgaria,2006,278703,194900,25864,499467
Bulgaria,2007,323896,237982,43274,605152
Bulgaria,2008,313450,277663,69605,660718
Bulgaria,2009,259686,202914,60498,523098
Bulgaria,2010,262537,212871,60080,535488
Bulgaria,2011,262142,233430,75531,571103
Bulgaria,2012,259987,210580,72572,543139
Bulgaria,2013,282954,241957,81308,606219
Bulgaria,2014,311689,276024,87518,675231
Bulgaria,2015,268418,245040,74010,587468
Bulgaria,2016,324618,291321,92419,708358
Bulgaria,2017,350439,283505,101063,735007
Bulgaria,2018,367982,310663,120151,798796
Bulgaria,2019,377340,306930,126611,810881
Bulgaria,2020,336322,266790,168863,771975
Bulgaria,2021,432642,318312,175769,926723
Bulgaria,2022,593433,410718,210902,1215053
Bulgaria,2023,550939,434346,223698,1208983
Bulgaria,2024,545062,440423,190085,1175570
Burkina Faso,2005,2256,1090,7489,10835
Burkina Faso,2006,2132,4413,8329,14874
Burkina Faso,2007,2784,4453,8717,15954
Burkina Faso,2008,5474,2613,20580,28667
Burkina Faso,2009,5364,4288,21648,31300
Burkina Faso,2010,4489,4905,30587,39981
Burkina Faso,2011,4490,5109,20243,29842
Burkina Faso,2012,7110,8797,18255,34162
Burkina Faso,2013,9708,12299,62165,84172
Burkina Faso,2014,6029,10317,26204,42550
Burkina Faso,2015,4376,7084,19308,30768
Burkina Faso,2016,9263,15573,61564,86400
Burkina Faso,2017,15813,6063,17333,39209
Burkina Faso,2018,13926,7321,19339,40586
Burkina Faso,2019,14406,6273,52890,73569
Burkina Faso,2020,8540,18415,45113,72068
Burkina Faso,2021,12773,12662,36389,61824
Burkina Faso,2022,5530,4078,61291,70899
Burkina Faso,2023,7730,5605,23717,37052
Burkina Faso,2024,12406,6847,32375,51628
Burundi,2005,407,286,5584,6277
Burundi,2006,578,1229,8869,10676
Burundi,2007,2182,346,5383,7911
Burundi,2008,268,406,9002,9676
Burundi,2009,591,1823,11531,13945
Burundi,2010,722,2450,8955,12127
Burundi,2011,3410,889,17417,21716
Burundi,2012,2897,7549,14996,25442
Burundi,2013,2568,5269,20739,28576
Burundi,2014,2245,1174,14990,18409
Burundi,2015,1112,698,20966,22776
Burundi,2016,4035,6062,15215,25312
Burundi,2017,2953,6708,28677,38338
Burundi,2018,3234,6176,17283,26693
Burundi,2019,3591,7070,39796,50457
Burundi,2020,2664,2854,25914,31432
Burundi,2021,2474,3468,30781,36723
Burundi,2022,2424,4453,46280,53157
Burundi,2023,3268,4208,32044,39520
Burundi,2024,3707,5300,30538,39545
Cabo Verde,2005,1169,1478,4247,6894
Cabo Verde,2006,1645,2172,4829,8646
Cabo Verde,2007,1348,1989,4786,8123
Cabo Verde,2008,3038,1974,6887,11899
Cabo Verde,2009,1333,2219,5542,9094
Cabo Verde,2010,1336,1727,5106,8169
Cabo Verde,2011,2960,2358,6418,11736
Cabo Verde,2012,2396,1802,5311,9509
Cabo Verde,2013,1765,2106,6700,10571
Cabo Verde,2014,1979,2551,7888,12418
Cabo Verde,2015,1729,1532,7911,11172
Cabo Verde,2016,2322,1261,8346,11929
Cabo Verde,2017,1824,2179,10547,14550
Cabo Verde,2018,1804,2704,12477,16985
Cabo Verde,2019,1854,2039,10565,14458
Cabo Verde,2020,1516,1243,12501,15260
Cabo Verde,2021,2316,1813,13734,17863
Cabo Verde,2022,1758,1714,11236,14708
Cabo Verde,2023,2295,2195,11228,15718
Cabo Verde,2024,3305,2939,11342,17586
Cambodia,2005,1351,38886,48171,88408
Cambodia,2006,2384,51207,48245,101836
Cambodia,2007,4220,61706,55580,121506
Cambodia,2008,3141,33803,54200,91144
Cambodia,2009,12169,29145,68601,109915
Cambodia,2010,14761,21774,73690,110225
Cambodia,2011,5206,44128,84565,133899
Cambodia,2012,5247,60558,82113,147918
Cambodia,2013,11765,71925,59078,142768
Cambodia,2014,14602,93180,75619,183401
Cambodia,2015,17515,59912,83288,160715
Cambodia,2016,30937,58350,76223,165510
Cambodia,2017,31256,59670,93752,184678
Cambodia,2018,35506,65650,131502,232658
Cambodia,2019,24962,86820,122883,234665
Cambodia,2020,18555,92948,113659,225162
Cambodia,2021,14223,114852,110415,239490
Cambodia,2022,34334,116229,114512,265075
Cambodia,2023,55427,112915,112152,280494
Cambodia,2024,54763,124427,117947,297137
Cameroon,2005,8520,2455,0,10975
Cameroon,2006,8460,3933,51279,63672
Cameroon,2007,11822,5324,67700,84846
Cameroon,2008,12483,4751,86987,104221
Cameroon,2009,14955,6457,83863,105275
Cameroon,2010,16604,5673,80122,102399
Cameroon,2011,18424,6839,142144,167407
Cameroon,2012,15740,5066,96213,117019
Cameroon,2013,10975,7145,98662,116782
Cameroon,2014,10439,7225,96342,114006
Cameroon,2015,10091,5661,136204,151956
Cameroon,2016,11859,5449,97043,114351
Cameroon,2017,7463,5907,95758,109128
Cameroon,2018,7247,7125,112498,126870
Cameroon,2019,13731,7498,105611,126840
Cameroon,2020,5833,8455,99576,113864
Cameroon,2021,7016,7171,96381,110568
Cameroon,2022,155884,62637,190104,408625
Cameroon,2023,181574,109887,154541,446002
Cameroon,2024,0,0,0,0
Canada,2005,2455371,2918620,899126,6273117
Canada,2006,2935543,3220371,975772,7131686
Canada,2007,3347549,3560945,1092546,8001040
Canada,2008,3728162,3725293,1156386,8609841
Canada,2009,3430775,3426354,1017140,7874269
Canada,2010,3865726,3677132,1180011,8722869
Canada,2011,4411734,4242168,1287883,9941785
Canada,2012,4281677,4223346,1375056,9880079
Canada,2013,4660382,4400109,1399703,10460194
Canada,2014,4764207,4407907,1411379,10583493
Canada,2015,4678599,4345627,1316368,10340594
Canada,2016,4547766,4233793,1286314,10067873
Canada,2017,4857440,4364103,1374760,10596303
Canada,2018,5081262,4596904,1428323,11106489
Canada,2019,5327294,4777833,1415918,11521045
Canada,2020,4345161,4298032,3474293,12117486
Canada,2021,5650715,4031645,2198405,11880765
Canada,2022,7123951,5348521,2111697,14584169
Canada,2023,5802058,5050675,1526560,12379293
Canada,2024,5970623,4827673,1551212,12349508
Cayman Islands,2005,0,0,0,0
Cayman Islands,2006,0,0,0,0
Cayman Islands,2007,0,0,0,0
Cayman Islands,2008,0,0,0,0
Cayman Islands,2009,0,0,0,0
Cayman Islands,2010,0,0,0,0
Cayman Islands,2011,0,0,0,0
Cayman Islands,2012,0,0,0,0
Cayman Islands,2013,0,0,0,0
Cayman Islands,2014,0,0,0,0
Cayman Islands,2015,0,0,0,0
Cayman Islands,2016,0,0,0,0
Cayman Islands,2017,0,0,0,0
Cayman Islands,2018,0,0,0,0
Cayman Islands,2019,0,0,0,0
Cayman Islands,2020,16192,21039,11221,48452
Cayman Islands,2021,22204,24304,8475,54983
Cayman Islands,2022,2493,3989,7363,13845
Cayman Islands,2023,3614,4418,8568,16600
Cayman Islands,2024,0,0,0,0
Central African Republic,2005,0,0,0,0
Central African Republic,2006,0,0,0,0
Central African Republic,2007,139,138,6762,7039
Central African Republic,2008,268,320,10784,11372
Central African Republic,2009,262,94,10454,10810
Central African Republic,2010,249,69,6437,6755
Central African Republic,2011,180,187,5842,6209
Central African Republic,2012,163,197,5290,5650
Central African Republic,2013,20,72,3736,3828
Central African Republic,2014,292,525,17298,18115
Central African Republic,2015,208,235,10673,11116
Central African Republic,2016,2260,417,3953,6630
Central African Republic,2017,1864,690,15051,17605
Central African Republic,2018,2890,994,4893,8777
Central African Republic,2019,4734,1077,12301,18112
Central African Republic,2020,2923,2523,17326,22772
Central African Republic,2021,1923,1989,19616,23528
Central African Republic,2022,795,2307,22315,25417
Central African Republic,2023,577,1072,15586,17235
Central African Republic,2024,0,0,0,0
Chad,2005,1035,535,5677,7247
Chad,2006,509,866,5290,6665
Chad,2007,4806,4809,5474,15089
Chad,2008,628,6470,4109,11207
Chad,2009,604,3847,9967,14418
Chad,2010,810,1996,9008,11814
Chad,2011,313,5081,6485,11879
Chad,2012,538,7317,6682,14537
Chad,2013,3203,3969,22190,29362
Chad,2014,5102,5950,9004,20056
Chad,2015,872,3770,9494,14136
Chad,2016,3623,18302,11791,33716
Chad,2017,5539,7008,17764,30311
Chad,2018,2604,6645,21226,30475
Chad,2019,2626,3958,18429,25013
Chad,2020,5351,9813,19301,34465
Chad,2021,3607,99198,16804,119609
Chad,2022,2122,4689,24891,31702
Chad,2023,2790,8827,23764,35381
Chad,2024,0,0,0,0
Chile,2005,343250,404159,102669,850078
Chile,2006,434511,509466,133086,1077063
Chile,2007,515775,589753,145261,1250789
Chile,2008,604135,666091,175121,1445347
Chile,2009,538585,582924,143016,1264525
Chile,2010,692394,704203,208639,1605236
Chile,2011,918772,972457,248690,2139919
Chile,2012,939575,1059886,276378,2275839
Chile,2013,1086330,1152822,305952,2545104
Chile,2014,1114510,1165417,308713,2588640
Chile,2015,1069474,1076143,290370,2435987
Chile,2016,1047865,1054024,298355,2400244
Chile,2017,1174893,1163222,328156,2666271
Chile,2018,1284782,1297715,376097,2958594
Chile,2019,1223907,1209005,364655,2797567
Chile,2020,882554,821955,612662,2317171
Chile,2021,1399066,1015408,663969,3078443
Chile,2022,1918493,1366698,615873,3901064
Chile,2023,1231995,1041896,353045,2626936
Chile,2024,1290422,1126705,395541,2812668
China,2005,695456,814993,119314,1629763
China,2006,717047,868459,137800,1723306
China,2007,789904,1022373,172581,1984858
China,2008,853704,1221966,279822,2355492
China,2009,633170,1018575,241058,1892803
China,2010,818220,1420024,262066,2500310
China,2011,1187148,2385177,410386,3982711
China,2012,1344869,2662955,394320,4402144
China,2013,1667714,3148793,430252,5246759
China,2014,2065514,3559322,483373,6108209
China,2015,2309886,3694918,462577,6467381
China,2016,2379909,3588804,450716,6419429
China,2017,2798552,3819597,505006,7123155
China,2018,3387416,4173539,484756,8045711
China,2019,3654344,4478233,477074,8609651
China,2020,3514423,4744634,1408685,9667742
China,2021,4662593,6071743,477994,11212330
China,2022,4180637,5386010,384094,9950741
China,2023,3963544,5283941,337548,9585033
China,2024,3859522,5894016,319765,10073303
Christmas Island,2005,27,10,444,481
Christmas Island,2006,16,327,190,533
Christmas Island,2007,4,63,109,176
Christmas Island,2008,7,1,25,33
Christmas Island,2009,192,143,142,477
Christmas Island,2010,216,717,446,1379
Christmas Island,2011,430,354,291,1075
Christmas Island,2012,272,459,234,965
Christmas Island,2013,539,844,139,1522
Christmas Island,2014,45,30,82,157
Christmas Island,2015,39,137,46,222
Christmas Island,2016,0,30,43,73
Christmas Island,2017,2,31,100,133
Christmas Island,2018,0,14,17,31
Christmas Island,2019,5,16,36,57
Christmas Island,2020,4,14,435,453
Christmas Island,2021,17,56,136,209
Christmas Island,2022,29,35,96,160
Christmas Island,2023,43,92,97,232
Christmas Island,2024,0,0,0,0
Cocos (Keeling) Islands,2005,20,14,6,40
Cocos (Keeling) Islands,2006,23,4,47,74
Cocos (Keeling) Islands,2007,41,0,3,44
Cocos (Keeling) Islands,2008,1,6,24,31
Cocos (Keeling) Islands,2009,16,8,10,34
Cocos (Keeling) Islands,2010,244,6,8,258
Cocos (Keeling) Islands,2011,0,6,21,27
Cocos (Keeling) Islands,2012,9,43,20,72
Cocos (Keeling) Islands,2013,80,8,179,267
Cocos (Keeling) Islands,2014,8,6,16,30
Cocos (Keeling) Islands,2015,38,65,279,382
Cocos (Keeling) Islands,2016,1,15,649,665
Cocos (Keeling) Islands,2017,4,41,33,78
Cocos (Keeling) Islands,2018,0,11,10,21
Cocos (Keeling) Islands,2019,7,3,30,40
Cocos (Keeling) Islands,2020,9,0,15,24
Cocos (Keeling) Islands,2021,5,6,40,51
Cocos (Keeling) Islands,2022,17,14,53,84
Cocos (Keeling) Islands,2023,7,39,82,128
Cocos (Keeling) Islands,2024,0,0,0,0
Colombia,2005,38576,53216,49023,140815
Colombia,2006,57120,67808,48741,173669
Colombia,2007,102886,108016,68388,279290
Colombia,2008,137415,135982,87074,360471
Colombia,2009,129439,128336,71339,329114
Colombia,2010,165224,165075,98078,428377
Colombia,2011,282810,278557,139689,701056
Colombia,2012,338541,356929,147943,843413
Colombia,2013,351480,389112,119325,859917
Colombia,2014,383691,404032,122537,910260
Colombia,2015,302142,339826,106303,748271
Colombia,2016,235888,267649,79952,583489
Colombia,2017,276530,308990,99014,684534
Colombia,2018,322419,349472,111580,783471
Colombia,2019,305338,346570,95955,747863
Colombia,2020,200017,207756,509364,917137
Colombia,2021,311657,271950,118143,701750
Colombia,2022,397420,361553,122333,881306
Colombia,2023,308816,282494,94551,685861
Colombia,2024,302918,274500,108902,686320
Comoros,2005,213,167,320,700
Comoros,2006,0,0,0,0
Comoros,2007,280,220,517,1017
Comoros,2008,666,901,503,2070
Comoros,2009,491,1401,1127,3019
Comoros,2010,384,1121,653,2158
Comoros,2011,456,1109,1475,3040
Comoros,2012,555,1125,761,2441
Comoros,2013,474,1168,2771,4413
Comoros,2014,572,1545,1056,3173
Comoros,2015,411,1176,718,2305
Comoros,2016,461,1008,2522,3991
Comoros,2017,784,1360,1194,3338
Comoros,2018,917,1183,1512,3612
Comoros,2019,638,1150,1108,2896
Comoros,2020,482,1265,1072,2819
Comoros,2021,825,1960,1893,4678
Comoros,2022,755,1560,1570,3885
Comoros,2023,862,1981,1456,4299
Comoros,2024,0,0,0,0
Congo,2005,0,0,0,0
Congo,2006,0,0,0,0
Congo,2007,1496,6382,13431,21309
Congo,2008,1861,8425,16283,26569
Congo,2009,2772,7744,15603,26119
Congo,2010,2656,7330,14224,24210
Congo,2011,2717,9908,23877,36502
Congo,2012,6399,10656,18140,35195
Congo,2013,3396,10658,17989,32043
Congo,2014,4685,16440,20335,41460
Congo,2015,4053,8868,19848,32769
Congo,2016,3989,7575,22926,34490
Congo,2017,8228,11763,27834,47825
Congo,2018,3539,3939,15845,23323
Congo,2019,3267,5032,27116,35415
Congo,2020,2320,5140,19570,27030
Congo,2021,3317,6086,21853,31256
Congo,2022,3860,7766,29804,41430
Congo,2023,114978,72213,48650,235841
Congo,2024,0,0,0,0
"Congo, Democratic Republic of the",2005,0,0,0,0
"Congo, Democratic Republic of the",2006,0,0,0,0
"Congo, Democratic Republic of the",2007,0,0,0,0
"Congo, Democratic Republic of the",2008,0,0,0,0
"Congo, Democratic Republic of the",2009,0,0,0,0
"Congo, Democratic Republic of the",2010,0,0,0,0
"Congo, Democratic Republic of the",2011,0,0,0,0
"Congo, Democratic Republic of the",2012,0,0,0,0
"Congo, Democratic Republic of the",2013,0,0,0,0
"Congo, Democratic Republic of the",2014,0,0,0,0
"Congo, Democratic Republic of the",2015,7269,9959,157525,174753
"Congo, Democratic Republic of the",2016,5053,8782,126635,140470
"Congo, Democratic Republic of the",2017,5021,10796,143766,159583
"Congo, Democratic Republic of the",2018,5928,12464,164102,182494
"Congo, Democratic Republic of the",2019,5899,17153,160002,183054
"Congo, Democratic Republic of the",2020,6364,18212,134605,159181
"Congo, Democratic Republic of the",2021,11639,31670,291689,334998
"Congo, Democratic Republic of the",2022,20339,47923,395580,463842
"Congo, Democratic Republic of the",2023,31390,39646,334355,405391
"Congo, Democratic Republic of the",2024,0,0,0,0
Cook Islands,2005,621,1146,632,2399
Cook Islands,2006,593,593,419,1605
Cook Islands,2007,665,812,734,2211
Cook Islands,2008,683,1151,497,2331
Cook Islands,2009,698,639,431,1768
Cook Islands,2010,1336,682,498,2516
Cook Islands,2011,881,825,521,2227
Cook Islands,2012,764,737,852,2353
Cook Islands,2013,1006,733,683,2422
Cook Islands,2014,958,869,632,2459
Cook Islands,2015,1005,836,804,2645
Cook Islands,2016,875,799,932,2606
Cook Islands,2017,825,664,684,2173
Cook Islands,2018,992,794,751,2537
Cook Islands,2019,751,933,591,2275
Cook Islands,2020,412,645,544,1601
Cook Islands,2021,478,490,816,1784
Cook Islands,2022,764,542,645,1951
Cook Islands,2023,1013,707,722,2442
Cook Islands,2024,0,0,0,0
Costa Rica,2005,126475,203504,22322,352301
Costa Rica,2006,120172,82596,27465,230233
Costa Rica,2007,131588,96427,33127,261142
Costa Rica,2008,135640,118898,39390,293928
Costa Rica,2009,89998,64998,24597,179593
Costa Rica,2010,98382,123063,37899,259344
Costa Rica,2011,102937,165572,52771,321280
Costa Rica,2012,122851,160071,101717,384639
Costa Rica,2013,126708,154989,68121,349818
Costa Rica,2014,121879,154357,59721,335957
Costa Rica,2015,118792,161698,63673,344163
Costa Rica,2016,127091,158281,74538,359910
Costa Rica,2017,123504,162027,80986,366517
Costa Rica,2018,138471,173546,73628,385645
Costa Rica,2019,126324,163753,79924,370001
Costa Rica,2020,95452,129716,121579,346747
Costa Rica,2021,143641,155819,111339,410799
Costa Rica,2022,159359,155316,108562,423237
Costa Rica,2023,147465,176860,104564,428889
Costa Rica,2024,169677,180385,112228,462290
Croatia,2005,185316,207011,54620,446947
Croatia,2006,237166,248981,69042,555189
Croatia,2007,329418,322498,83477,735393
Croatia,2008,368235,347581,92857,808673
Croatia,2009,323464,281590,70785,675839
Croatia,2010,303632,242544,64486,610662
Croatia,2011,378627,285113,78009,741749
Croatia,2012,339737,243600,67505,650842
Croatia,2013,349496,240570,70319,660385
Croatia,2014,677388,336414,87192,1100994
Croatia,2015,594840,322942,81088,998870
Croatia,2016,611784,390890,83668,1086342
Croatia,2017,670566,421598,100121,1192285
Croatia,2018,778656,465696,122289,1366641
Croatia,2019,763012,468243,115131,1346386
Croatia,2020,763699,442312,169224,1375235
Croatia,2021,899401,492524,135630,1527555
Croatia,2022,997920,566396,130997,1695313
Croatia,2023,1125375,684988,139631,1949994
Croatia,2024,1189547,791105,152884,2133536
Cuba,2005,32175,48889,41269,122333
Cuba,2006,36784,47424,36523,120731
Cuba,2007,0,0,0,0
Cuba,2008,0,0,0,0
Cuba,2009,0,0,0,0
Cuba,2010,0,0,0,0
Cuba,2011,0,0,0,0
Cuba,2012,0,0,0,0
Cuba,2013,0,0,0,0
Cuba,2014,0,0,0,0
Cuba,2015,0,0,0,0
Cuba,2016,32932,39770,36715,109417
Cuba,2017,26532,31235,41634,99401
Cuba,2018,21620,24746,37009,83375
Cuba,2019,11343,18924,32867,63134
Cuba,2020,6359,9780,24179,40318
Cuba,2021,6623,14302,23735,44660
Cuba,2022,10408,21865,42095,74368
Cuba,2023,20235,35178,22961,78374
Cuba,2024,0,0,0,0
Curaçao,2005,0,0,0,0
Curaçao,2006,0,0,0,0
Curaçao,2007,0,0,0,0
Curaçao,2008,0,0,0,0
Curaçao,2009,0,0,0,0
Curaçao,2010,0,0,0,0
Curaçao,2011,0,0,0,0
Curaçao,2012,0,0,0,0
Curaçao,2013,0,0,0,0
Curaçao,2014,0,0,0,0
Curaçao,2015,0,0,0,0
Curaçao,2016,0,0,0,0
Curaçao,2017,7021,27291,6725,41037
Curaçao,2018,6855,27220,6927,41002
Curaçao,2019,7755,26627,6733,41115
Curaçao,2020,5899,18455,9553,33907
Curaçao,2021,18261,25733,7795,51789
Curaçao,2022,25221,30354,12738,68313
Curaçao,2023,18399,27601,9969,55969
Curaçao,2024,0,0,0,0
Cyprus,2005,107570,156442,24226,288238
Cyprus,2006,108625,174759,25431,308815
Cyprus,2007,146571,216801,32691,396063
Cyprus,2008,168513,243446,38523,450482
Cyprus,2009,170604,208305,29489,408398
Cyprus,2010,162232,181654,27597,371483
Cyprus,2011,152238,193333,31447,377018
Cyprus,2012,136738,165560,22508,324806
Cyprus,2013,115642,143228,21717,280587
Cyprus,2014,128224,165172,29138,322534
Cyprus,2015,108980,130994,23754,263728
Cyprus,2016,111116,133291,23226,267633
Cyprus,2017,122856,138257,28352,289465
Cyprus,2018,134367,138701,28927,301995
Cyprus,2019,135444,140591,29616,305651
Cyprus,2020,126952,121531,42912,291395
Cyprus,2021,153529,177233,34451,365213
Cyprus,2022,160170,166840,38952,365962
Cyprus,2023,169876,204922,39307,414105
Cyprus,2024,189101,234147,39149,462397
Czech Republic,2005,518193,749370,214639,1482202
Czech Republic,2006,493820,706271,231705,1431796
Czech Republic,2007,601097,837091,272325,1710513
Czech Republic,2008,805661,1077900,324171,2207732
Czech Republic,2009,731464,961788,248949,1942201
Czech Republic,2010,763094,979137,259455,2001686
Czech Republic,2011,957547,1092458,296218,2346223
Czech Republic,2012,844136,970057,279859,2094052
Czech Republic,2013,897689,1018594,284732,2201015
Czech Republic,2014,1090723,1167377,345310,2603410
Czech Republic,2015,1010187,1105747,318290,2434224
Czech Republic,2016,1283619,1285819,369059,2938497
Czech Republic,2017,1530391,1467755,422043,3420189
Czech Republic,2018,1640363,1496732,509920,3647015
Czech Republic,2019,1675551,1482471,501908,3659930
Czech Republic,2020,1627868,1469187,924085,4021140
Czech Republic,2021,2081241,1715877,728883,4526001
Czech Republic,2022,2309273,1886492,610929,4806694
Czech Republic,2023,2207653,1879212,582005,4668870
Czech Republic,2024,2356211,1988737,584933,4929881
Côte d'Ivoire,2005,5242,6884,24326,36452
Côte d'Ivoire,2006,6654,6714,27695,41063
Côte d'Ivoire,2007,21518,7614,33238,62370
Côte d'Ivoire,2008,8964,8652,41450,59066
Côte d'Ivoire,2009,10628,13187,46577,70392
Côte d'Ivoire,2010,11373,9429,69860,90662
Côte d'Ivoire,2011,7309,6328,55846,69483
Côte d'Ivoire,2012,12132,21312,63493,96937
Côte d'Ivoire,2013,9550,10693,68515,88758
Côte d'Ivoire,2014,14912,19153,281861,315926
Côte d'Ivoire,2015,17853,16240,74287,108380
Côte d'Ivoire,2016,16384,15693,65387,97464
Côte d'Ivoire,2017,16372,16231,102195,134798
Côte d'Ivoire,2018,17003,19269,62445,98717
Côte d'Ivoire,2019,17425,16142,64897,98464
Côte d'Ivoire,2020,14422,18248,91596,124266
Côte d'Ivoire,2021,15325,23446,183571,222342
Côte d'Ivoire,2022,13947,25715,88553,128215
Côte d'Ivoire,2023,18626,24216,83201,126043
Côte d'Ivoire,2024,18172,19853,81027,119052
Denmark,2005,1375768,1721768,282608,3380144
Denmark,2006,1657394,1928474,346613,3932481
Denmark,2007,1922469,2275257,386685,4584411
Denmark,2008,2035854,2428036,444709,4908599
Denmark,2009,1762160,2067976,353220,4183356
Denmark,2010,1933783,2140521,377237,4451541
Denmark,2011,2106375,2514092,444451,5064918
Denmark,2012,1976027,2364772,410785,4751584
Denmark,2013,2088830,2288244,450724,4827798
Denmark,2014,2338834,2575557,490283,5404674
Denmark,2015,1982123,2316819,447541,4746483
Denmark,2016,1983533,2359351,464664,4807548
Denmark,2017,2117780,2493279,475536,5086595
Denmark,2018,2352495,2700300,526836,5579631
Denmark,2019,2244039,2655275,516504,5415818
Denmark,2020,2106145,2525313,697555,5329013
Denmark,2021,2878603,2816323,700933,6395859
Denmark,2022,3100827,3451891,684232,7236950
Denmark,2023,2334990,2773232,578243,5686465
Denmark,2024,2679641,2997112,617879,6294632
Djibouti,2005,0,0,0,0
Djibouti,2006,0,0,0,0
Djibouti,2007,0,0,0,0
Djibouti,2008,0,0,0,0
Djibouti,2009,1063,9260,4768,15091
Djibouti,2010,0,0,0,0
Djibouti,2011,0,0,0,0
Djibouti,2012,0,0,0,0
Djibouti,2013,0,0,0,0
Djibouti,2014,0,0,0,0
Djibouti,2015,0,0,0,0
Djibouti,2016,0,0,0,0
Djibouti,2017,0,0,0,0
Djibouti,2018,0,0,0,0
Djibouti,2019,0,0,0,0
Djibouti,2020,0,0,0,0
Djibouti,2021,2540,10242,25000,37782
Djibouti,2022,13103,10445,14943,38491
Djibouti,2023,3969,11351,10995,26315
Djibouti,2024,0,0,0,0
Dominica,2005,1585,1128,874,3587
Dominica,2006,981,1311,501,2793
Dominica,2007,671,1554,760,2985
Dominica,2008,815,1755,1317,3887
Dominica,2009,825,1792,1086,3703
Dominica,2010,690,2743,2929,6362
Dominica,2011,695,2889,751,4335
Dominica,2012,574,2900,869,4343
Dominica,2013,513,3039,1396,4948
Dominica,2014,0,0,0,0
Dominica,2015,0,0,0,0
Dominica,2016,626,2222,1481,4329
Dominica,2017,490,1834,1211,3535
Dominica,2018,632,2681,2421,5734
Dominica,2019,1104,2593,2948,6645
Dominica,2020,438,1216,1907,3561
Dominica,2021,476,1560,3292,5328
Dominica,2022,571,1704,1976,4251
Dominica,2023,524,1760,2160,4444
Dominica,2024,0,0,0,0
Dominican Republic,2005,272619,256854,58180,587653
Dominican Republic,2006,384244,198183,62770,645197
Dominican Republic,2007,171088,154104,67521,392713
Dominican Republic,2008,137500,185971,62979,386450
Dominican Republic,2009,91000,92582,59647,243229
Dominican Republic,2010,78020,107755,60185,245960
Dominican Republic,2011,97775,103780,75322,276877
Dominican Republic,2012,100009,131992,72584,304585
Dominican Republic,2013,80530,118355,87043,285928
Dominican Republic,2014,108962,167920,220599,497481
Dominican Republic,2015,116139,181648,143066,440853
Dominican Republic,2016,106792,150437,125594,382823
Dominican Republic,2017,116679,151863,138035,406577
Dominican Republic,2018,119719,121321,137687,378727
Dominican Republic,2019,101904,113152,150485,365541
Dominican Republic,2020,73249,110888,305680,489817
Dominican Republic,2021,114669,137833,203466,455968
Dominican Republic,2022,146315,129648,186098,462061
Dominican Republic,2023,157018,136892,173856,467766
Dominican Republic,2024,158381,135829,174350,468560
Ecuador,2005,54587,69378,17850,141815
Ecuador,2006,65354,76757,21699,163810
Ecuador,2007,81969,90176,30343,202488
Ecuador,2008,106236,101063,34982,242281
Ecuador,2009,32887,37057,31950,101894
Ecuador,2010,52353,64054,24211,140618
Ecuador,2011,86568,103863,28651,219082
Ecuador,2012,99525,124649,23800,247974
Ecuador,2013,122273,161706,24841,308820
Ecuador,2014,120060,174133,26725,320918
Ecuador,2015,100371,144556,38282,283209
Ecuador,2016,67391,91501,13924,172816
Ecuador,2017,78091,109336,16495,203922
Ecuador,2018,93463,131922,22444,247829
Ecuador,2019,103596,144909,21604,270109
Ecuador,2020,66522,95139,159894,321555
Ecuador,2021,100901,124334,59150,284385
Ecuador,2022,132210,167245,46010,345465
Ecuador,2023,146138,190715,49337,386190
Ecuador,2024,138579,164815,41088,344482
Egypt,2005,1635,10981,12575,25191
Egypt,2006,11295,45481,10781,67557
Egypt,2007,6936,40490,24382,71808
Egypt,2008,25859,314489,64635,404983
Egypt,2009,35851,353050,91321,480222
Egypt,2010,49423,516704,91088,657215
Egypt,2011,42058,336545,80461,459064
Egypt,2012,34572,385009,91648,511229
Egypt,2013,55830,443031,84341,583202
Egypt,2014,65285,814808,135790,1015883
Egypt,2015,128383,1039743,120795,1288921
Egypt,2016,98883,548550,67571,715004
Egypt,2017,81995,333444,52346,467785
Egypt,2018,134903,433397,67493,635793
Egypt,2019,211729,326525,62297,600551
Egypt,2020,179256,213041,103846,496143
Egypt,2021,192032,210460,74778,477270
Egypt,2022,136601,209668,55099,401368
Egypt,2023,113716,176072,54382,344170
Egypt,2024,0,0,0,0
El Salvador,2005,246122,104485,48234,398841
El Salvador,2006,216315,98986,32122,347423
El Salvador,2007,227264,97274,37624,362162
El Salvador,2008,200565,98084,41595,340244
El Salvador,2009,163196,99459,36862,299517
El Salvador,2010,186061,103440,31011,320512
El Salvador,2011,199787,114287,38042,352116
El Salvador,2012,203673,123374,42435,369482
El Salvador,2013,263129,132715,46196,442040
El Salvador,2014,271383,127175,50480,449038
El Salvador,2015,181196,121998,50641,353835
El Salvador,2016,165743,107762,53598,327103
El Salvador,2017,167630,102026,63117,332773
El Salvador,2018,173833,111367,65554,350754
El Salvador,2019,168527,102075,70515,341117
El Salvador,2020,323233,82652,130073,535958
El Salvador,2021,490211,113496,126459,730166
El Salvador,2022,527406,105671,115277,748354
El Salvador,2023,400261,100805,100094,601160
El Salvador,2024,374357,106477,102825,583659
Equatorial Guinea,2005,806,476,7465,8747
Equatorial Guinea,2006,1235,1771,11668,14674
Equatorial Guinea,2007,1864,1561,15343,18768
Equatorial Guinea,2008,5022,5227,19321,29570
Equatorial Guinea,2009,1750,2850,8722,13322
Equatorial Guinea,2010,2881,4703,7387,14971
Equatorial Guinea,2011,3471,7215,11781,22467
Equatorial Guinea,2012,6190,6621,10415,23226
Equatorial Guinea,2013,3849,5963,11102,20914
Equatorial Guinea,2014,3054,12233,13660,28947
Equatorial Guinea,2015,4318,5440,11637,21395
Equatorial Guinea,2016,4240,8549,8825,21614
Equatorial Guinea,2017,5562,2990,7907,16459
Equatorial Guinea,2018,3130,4201,9392,16723
Equatorial Guinea,2019,2224,3018,9113,14355
Equatorial Guinea,2020,1767,3506,10721,15994
Equatorial Guinea,2021,2173,3093,10107,15373
Equatorial Guinea,2022,3174,3029,13496,19699
Equatorial Guinea,2023,5163,4847,9813,19823
Equatorial Guinea,2024,0,0,0,0
Eritrea,2005,312,1011,2698,4021
Eritrea,2006,106,1613,1526,3245
Eritrea,2007,793,1391,1612,3796
Eritrea,2008,976,1793,1044,3813
Eritrea,2009,396,809,1011,2216
Eritrea,2010,415,1222,4697,6334
Eritrea,2011,401,1102,854,2357
Eritrea,2012,1513,7556,1267,10336
Eritrea,2013,938,2653,1740,5331
Eritrea,2014,1289,4298,1981,7568
Eritrea,2015,1145,1822,961,3928
Eritrea,2016,1318,1507,2200,5025
Eritrea,2017,1477,1289,1127,3893
Eritrea,2018,970,2145,1016,4131
Eritrea,2019,1015,2000,1615,4630
Eritrea,2020,446,5540,6023,12009
Eritrea,2021,601,2190,1756,4547
Eritrea,2022,427,1131,1625,3183
Eritrea,2023,258,535,4743,5536
Eritrea,2024,0,0,0,0
Estonia,2005,96033,121400,33785,251218
Estonia,2006,125495,157064,42338,324897
Estonia,2007,166805,207275,48335,422415
Estonia,2008,266079,276653,65940,608672
Estonia,2009,177450,193482,39165,410097
Estonia,2010,162120,175280,45998,383398
Estonia,2011,176941,210427,58535,445903
Estonia,2012,178981,209046,69409,457436
Estonia,2013,200293,230919,73378,504590
Estonia,2014,245377,260407,80961,586745
Estonia,2015,151403,177904,63917,393224
Estonia,2016,171908,195045,76334,443287
Estonia,2017,175432,200972,78759,455163
Estonia,2018,179050,223133,74463,476646
Estonia,2019,174089,222481,81296,477866
Estonia,2020,146774,196515,120908,464197
Estonia,2021,188597,232860,107994,529451
Estonia,2022,202635,249485,116829,568949
Estonia,2023,205194,246788,90203,542185
Estonia,2024,183419,206431,81549,471399
Eswatini,2005,22771,22881,6994,52646
Eswatini,2006,16370,13124,4791,34285
Eswatini,2007,16825,13881,5868,36574
Eswatini,2008,15552,14200,5742,35494
Eswatini,2009,16588,15689,5089,37366
Eswatini,2010,31114,26808,11066,68988
Eswatini,2011,20938,19748,9721,50407
Eswatini,2012,19915,18389,8274,46578
Eswatini,2013,20550,19548,13014,53112
Eswatini,2014,21706,16016,6610,44332
Eswatini,2015,18288,13987,5202,37477
Eswatini,2016,14647,14658,5248,34553
Eswatini,2017,20003,17264,6841,44108
Eswatini,2018,22099,18779,8508,49386
Eswatini,2019,20556,19944,7699,48199
Eswatini,2020,17737,17171,9000,43908
Eswatini,2021,22219,20886,10799,53904
Eswatini,2022,22454,20925,10342,53721
Eswatini,2023,22236,22715,8040,52991
Eswatini,2024,0,0,0,0
Ethiopia,2005,38676,57838,31946,128460
Ethiopia,2006,31335,63024,77408,171767
Ethiopia,2007,29001,72005,52957,153963
Ethiopia,2008,32110,63085,17667,112862
Ethiopia,2009,35283,64438,21306,121027
Ethiopia,2010,44663,74784,82825,202272
Ethiopia,2011,50577,80184,44563,175324
Ethiopia,2012,89693,125228,51710,266631
Ethiopia,2013,103073,135543,56325,294941
Ethiopia,2014,107080,168191,68231,343502
Ethiopia,2015,97175,224575,82249,403999
Ethiopia,2016,93691,239305,51548,384544
Ethiopia,2017,118975,212434,79851,411260
Ethiopia,2018,60679,217621,65751,344051
Ethiopia,2019,57972,150857,70534,279363
Ethiopia,2020,39960,161424,116147,317531
Ethiopia,2021,28572,108830,94092,231494
Ethiopia,2022,26782,93746,102888,223416
Ethiopia,2023,41190,96734,42146,180070
Ethiopia,2024,0,0,0,0
Falkland Islands (Malvinas),2005,252,192,164,608
Falkland Islands (Malvinas),2006,196,239,69,504
Falkland Islands (Malvinas),2007,254,175,109,538
Falkland Islands (Malvinas),2008,180,125,408,713
Falkland Islands (Malvinas),2009,165,185,139,489
Falkland Islands (Malvinas),2010,248,288,142,678
Falkland Islands (Malvinas),2011,309,242,143,694
Falkland Islands (Malvinas),2012,385,222,211,818
Falkland Islands (Malvinas),2013,362,402,255,1019
Falkland Islands (Malvinas),2014,452,217,208,877
Falkland Islands (Malvinas),2015,441,362,703,1506
Falkland Islands (Malvinas),2016,293,214,171,678
Falkland Islands (Malvinas),2017,194,123,107,424
Falkland Islands (Malvinas),2018,255,198,253,706
Falkland Islands (Malvinas),2019,291,216,279,786
Falkland Islands (Malvinas),2020,318,160,307,785
Falkland Islands (Malvinas),2021,607,284,270,1161
Falkland Islands (Malvinas),2022,486,152,269,907
Falkland Islands (Malvinas),2023,701,344,379,1424
Falkland Islands (Malvinas),2024,0,0,0,0
Faroe Islands,2005,8046,8237,2054,18337
Faroe Islands,2006,10171,9773,2518,22462
Faroe Islands,2007,12574,11918,2992,27484
Faroe Islands,2008,12212,11359,3246,26817
Faroe Islands,2009,10000,9214,2490,21704
Faroe Islands,2010,7840,8382,1819,18041
Faroe Islands,2011,8042,8938,2248,19228
Faroe Islands,2012,7969,8626,2041,18636
Faroe Islands,2013,9896,9026,2231,21153
Faroe Islands,2014,9855,9199,2614,21668
Faroe Islands,2015,7974,7485,1887,17346
Faroe Islands,2016,8259,7796,2124,18179
Faroe Islands,2017,8325,8037,3063,19425
Faroe Islands,2018,9478,8270,3305,21053
Faroe Islands,2019,9582,8530,2748,20860
Faroe Islands,2020,9444,8346,3632,21422
Faroe Islands,2021,13225,10135,3984,27344
Faroe Islands,2022,10463,9602,2718,22783
Faroe Islands,2023,10901,8485,3052,22438
Faroe Islands,2024,0,0,0,0
Fiji,2005,7187,17059,9299,33545
Fiji,2006,6503,13805,8763,29071
Fiji,2007,7482,14797,8886,31165
Fiji,2008,8169,14828,10008,33005
Fiji,2009,6258,8937,7803,22998
Fiji,2010,8804,11809,11353,31966
Fiji,2011,6627,13964,8886,29477
Fiji,2012,7159,12476,11382,31017
Fiji,2013,8349,19506,12035,39890
Fiji,2014,8475,18686,15387,42548
Fiji,2015,8035,19266,11891,39192
Fiji,2016,9494,17820,18599,45913
Fiji,2017,9878,21072,13789,44739
Fiji,2018,10668,19767,17260,47695
Fiji,2019,9952,23173,14565,47690
Fiji,2020,5232,13293,12502,31027
Fiji,2021,6878,18485,15874,41237
Fiji,2022,15741,37639,16034,69414
Fiji,2023,12550,37949,16729,67228
Fiji,2024,0,0,0,0
Finland,2005,537501,715909,160208,1413618
Finland,2006,612556,762696,174381,1549633
Finland,2007,705353,844128,214875,1764356
Finland,2008,806684,975987,225088,2007759
Finland,2009,722394,826116,197359,1745869
Finland,2010,786507,853158,225861,1865526
Finland,2011,899231,1084890,237126,2221247
Finland,2012,788049,955299,218701,1962049
Finland,2013,841019,989789,226237,2057045
Finland,2014,816136,917877,215249,1949262
Finland,2015,648325,711175,176173,1535673
Finland,2016,678334,715837,191372,1585543
Finland,2017,711201,745055,205307,1661563
Finland,2018,735268,815136,213400,1763804
Finland,2019,718464,789700,222559,1730723
Finland,2020,662381,734799,482586,1879766
Finland,2021,657044,673677,335135,1665856
Finland,2022,825009,836569,306535,1968113
Finland,2023,683714,726230,228455,1638399
Finland,2024,679955,670610,232484,1583049
France,2005,7757544,9368530,1799911,18925985
France,2006,8217271,9771768,1962157,19951196
France,2007,9585409,10779798,2248753,22613960
France,2008,10462076,11842141,2386457,24690674
France,2009,9577307,10623114,2208797,22409218
France,2010,10129036,10525816,2360297,23015149
France,2011,11411223,11871432,2649496,25932151
France,2012,10213559,10814604,2342440,23370603
France,2013,10972866,11433620,2452402,24858888
France,2014,11711722,12228265,2607749,26547736
France,2015,10365654,11223730,2362842,23952226
France,2016,10375856,11322938,2364479,24063273
France,2017,10855558,11772243,2509993,25137794
France,2018,11798394,12683904,2756246,27238544
France,2019,11591438,12382466,2682686,26656590
France,2020,10270998,11049356,8883701,30204055
France,2021,12273580,12000934,3824312,28098826
France,2022,14038718,13128366,3563791,30730875
France,2023,12739444,12889186,3182773,28811403
France,2024,12547720,12784715,3181464,28513899
Free Zones,2005,326827,391635,36331,754793
Free Zones,2006,267322,339516,19947,626785
Free Zones,2007,252376,359621,19930,631927
Free Zones,2008,219847,323972,12950,556769
Free Zones,2009,134580,160096,6788,301464
Free Zones,2010,102989,122353,6777,232119
Free Zones,2011,100712,118482,13033,232227
Free Zones,2012,94951,109824,15002,219777
Free Zones,2013,13539,19631,17833,51003
Free Zones,2014,18074,18492,20657,57223
Free Zones,2015,68014,52380,18668,139062
Free Zones,2016,72384,41767,19803,133954
Free Zones,2017,56485,11260,12582,80327
Free Zones,2018,68299,17893,11589,97781
Free Zones,2019,10381,9508,3168,23057
Free Zones,2020,4865,4389,4314,13568
Free Zones,2021,11604,5914,4747,22265
Free Zones,2022,19226,7591,3695,30512
Free Zones,2023,12562,6081,1327,19970
Free Zones,2024,0,0,0,0
French Polynesia,2005,13332,18061,8728,40121
French Polynesia,2006,11697,15949,8831,36477
French Polynesia,2007,12482,18467,7969,38918
French Polynesia,2008,14802,21230,10159,46191
French Polynesia,2009,12971,18116,9948,41035
French Polynesia,2010,14505,16033,8108,38646
French Polynesia,2011,13668,14324,7166,35158
French Polynesia,2012,13519,15314,7689,36522
French Polynesia,2013,13646,16153,8561,38360
French Polynesia,2014,14039,16095,9397,39531
French Polynesia,2015,13079,16502,7598,37179
French Polynesia,2016,12749,15538,7955,36242
French Polynesia,2017,14204,16690,8341,39235
French Polynesia,2018,16577,19362,10006,45945
French Polynesia,2019,15680,18378,10524,44582
French Polynesia,2020,13113,14579,22155,49847
French Polynesia,2021,17107,20052,14384,51543
French Polynesia,2022,21378,23186,14384,58948
French Polynesia,2023,19051,16149,10204,45404
French Polynesia,2024,0,0,0,0
French Southern and Antarctic Territories,2005,397,284,797,1478
French Southern and Antarctic Territories,2006,298,239,843,1380
French Southern and Antarctic Territories,2007,346,747,457,1550
French Southern and Antarctic Territories,2008,620930,492053,47101,1160084
French Southern and Antarctic Territories,2009,538,350,152,1040
French Southern and Antarctic Territories,2010,292,412,48,752
French Southern and Antarctic Territories,2011,246,350,64,660
French Southern and Antarctic Territories,2012,146,610,73,829
French Southern and Antarctic Territories,2013,213,451,88,752
French Southern and Antarctic Territories,2014,352,1612,113,2077
French Southern and Antarctic Territories,2015,110,424,52,586
French Southern and Antarctic Territories,2016,199,211,95,505
French Southern and Antarctic Territories,2017,112,227,62,401
French Southern and Antarctic Territories,2018,43,129,127,299
French Southern and Antarctic Territories,2019,203,211,82,496
French Southern and Antarctic Territories,2020,68,188,18,274
French Southern and Antarctic Territories,2021,99,179,21,299
French Southern and Antarctic Territories,2022,59,206,92,357
French Southern and Antarctic Territories,2023,79,412,348,839
French Southern and Antarctic Territories,2024,0,0,0,0
Gabon,2005,3300,3567,8399,15266
Gabon,2006,4042,5782,12614,22438
Gabon,2007,3706,5551,29626,38883
Gabon,2008,4693,6193,11074,21960
Gabon,2009,3547,6697,12798,23042
Gabon,2010,3455,15563,16176,35194
Gabon,2011,3982,7669,17198,28849
Gabon,2012,5668,7268,14669,27605
Gabon,2013,5715,9258,13139,28112
Gabon,2014,5142,8759,11683,25584
Gabon,2015,4642,7134,10820,22596
Gabon,2016,3548,4959,11050,19557
Gabon,2017,3074,3992,8704,15770
Gabon,2018,4160,7432,9247,20839
Gabon,2019,3560,7859,8921,20340
Gabon,2020,3054,7698,12826,23578
Gabon,2021,3746,8169,14659,26574
Gabon,2022,3940,8738,15883,28561
Gabon,2023,4162,9034,16177,29373
Gabon,2024,0,0,0,0
Gambia,2005,498,452,4048,4998
Gambia,2006,558,839,5816,7213
Gambia,2007,925,602,6512,8039
Gambia,2008,645,495,7515,8655
Gambia,2009,613,257,4842,5712
Gambia,2010,528,231,2949,3708
Gambia,2011,502,385,2964,3851
Gambia,2012,417,945,2875,4237
Gambia,2013,498,108,2391,2997
Gambia,2014,742,211,3478,4431
Gambia,2015,797,116,3717,4630
Gambia,2016,668,164,3424,4256
Gambia,2017,1147,169,2901,4217
Gambia,2018,834,159,2669,3662
Gambia,2019,676,256,3673,4605
Gambia,2020,972,452,3378,4802
Gambia,2021,1017,115,4616,5748
Gambia,2022,788,122,4698,5608
Gambia,2023,1167,384,5416,6967
Gambia,2024,680,700,5653,7033
Georgia,2005,10568,21710,14949,47227
Georgia,2006,33293,33761,29097,96151
Georgia,2007,37044,51418,40507,128969
Georgia,2008,41432,92226,40077,173735
Georgia,2009,33213,43783,30220,107216
Georgia,2010,50709,69985,42864,163558
Georgia,2011,60449,97847,64460,222756
Georgia,2012,64056,101016,66014,231086
Georgia,2013,66158,99192,72698,238048
Georgia,2014,73397,106022,86310,265729
Georgia,2015,61053,84831,50144,196028
Georgia,2016,72757,97887,48376,219020
Georgia,2017,84016,101201,62499,247716
Georgia,2018,89219,92889,70418,252526
Georgia,2019,89263,95609,82036,266908
Georgia,2020,64722,63344,82277,210343
Georgia,2021,95398,102646,111627,309671
Georgia,2022,121300,140518,121239,383057
Georgia,2023,152691,172141,119396,444228
Georgia,2024,180476,197773,110880,489129
Germany,2005,10784112,13022316,2561487,26367915
Germany,2006,11805995,13940559,2732925,28479479
Germany,2007,12914407,15087177,2977498,30979082
Germany,2008,15479385,17382907,3728359,36590651
Germany,2009,14804902,15954898,3359857,34119657
Germany,2010,15960895,16417745,3796012,36174652
Germany,2011,18493086,19604080,4697645,42794811
Germany,2012,16213623,17315175,4054564,37583362
Germany,2013,17638019,18074683,4121304,39834006
Germany,2014,19009509,19079335,4513194,42602038
Germany,2015,16965911,17019569,4036983,38022463
Germany,2016,17467314,17493559,4176833,39137706
Germany,2017,19051641,18495676,4340397,41887714
Germany,2018,20233915,19690767,4647873,44572555
Germany,2019,19639904,19316522,4553423,43509849
Germany,2020,18990708,18156843,11729115,48876666
Germany,2021,22886583,19122658,6893001,48902242
Germany,2022,25419145,21377491,6026670,52823306
Germany,2023,21442613,19432896,4794809,45670318
Germany,2024,22480353,19978485,4876134,47334972
Ghana,2005,5531,11768,59975,77274
Ghana,2006,9887,15542,68984,94413
Ghana,2007,8953,20461,76586,106000
Ghana,2008,15908,21003,82063,118974
Ghana,2009,7117,15366,79559,102042
Ghana,2010,6558,18634,87456,112648
Ghana,2011,14501,29405,132135,176041
Ghana,2012,20355,29116,114371,163842
Ghana,2013,13355,32113,125632,171100
Ghana,2014,11846,22531,121157,155534
Ghana,2015,18025,16306,156308,190639
Ghana,2016,19328,13848,132697,165873
Ghana,2017,13254,17762,162585,193601
Ghana,2018,12299,15745,165925,193969
Ghana,2019,8942,13975,117181,140098
Ghana,2020,0,0,0,0
Ghana,2021,17211,18256,215262,250729
Ghana,2022,15539,10972,178019,204530
Ghana,2023,13956,13491,160964,188411
Ghana,2024,0,0,0,0
Gibraltar,2005,4563,9286,2246,16095
Gibraltar,2006,6177,8691,2963,17831
Gibraltar,2007,6552,9090,3075,18717
Gibraltar,2008,6719,7900,2733,17352
Gibraltar,2009,6943,7688,2455,17086
Gibraltar,2010,6640,7053,2699,16392
Gibraltar,2011,7832,6307,2398,16537
Gibraltar,2012,7360,4967,2353,14680
Gibraltar,2013,6833,5603,2795,15231
Gibraltar,2014,7153,6015,3432,16600
Gibraltar,2015,6344,5076,3997,15417
Gibraltar,2016,6745,4878,3317,14940
Gibraltar,2017,6110,4977,3842,14929
Gibraltar,2018,7741,5832,5767,19340
Gibraltar,2019,6761,5375,4690,16826
Gibraltar,2020,2932,2739,4558,10229
Gibraltar,2021,4049,3330,3839,11218
Gibraltar,2022,3470,3220,3887,10577
Gibraltar,2023,4319,3695,4890,12904
Gibraltar,2024,0,0,0,0
Greece,2005,690124,957822,203689,1851635
Greece,2006,806393,1060095,209012,2075500
Greece,2007,1325454,1357468,269997,2952919
Greece,2008,1622110,1630666,313302,3566078
Greece,2009,1369006,1408110,245257,3022373
Greece,2010,1160465,1126311,217643,2504419
Greece,2011,1083042,993191,183980,2260213
Greece,2012,862253,745605,133571,1741429
Greece,2013,873584,730611,153166,1757361
Greece,2014,929824,817191,173222,1920237
Greece,2015,766916,697041,153235,1617192
Greece,2016,843085,750461,177092,1770638
Greece,2017,885521,822155,174315,1881991
Greece,2018,978345,925008,185314,2088667
Greece,2019,1253006,1062752,202685,2518443
Greece,2020,898043,764404,333447,1995894
Greece,2021,1151264,889012,310060,2350336
Greece,2022,1357345,1064428,340396,2762169
Greece,2023,1182204,1141930,247700,2571834
Greece,2024,1243460,1215611,259683,2718754
Greenland,2005,7600,9857,2554,20011
Greenland,2006,9160,10072,2090,21322
Greenland,2007,9825,11677,2599,24101
Greenland,2008,9233,14531,2509,26273
Greenland,2009,9435,13736,2727,25898
Greenland,2010,9007,14088,2971,26066
Greenland,2011,9054,13775,3149,25978
Greenland,2012,10913,13078,3234,27225
Greenland,2013,11854,15059,3717,30630
Greenland,2014,8906,11620,2892,23418
Greenland,2015,8324,10325,2116,20765
Greenland,2016,7668,11784,2462,21914
Greenland,2017,7407,11630,2870,21907
Greenland,2018,8414,12691,3630,24735
Greenland,2019,8357,13886,4829,27072
Greenland,2020,10462,14687,5224,30373
Greenland,2021,11895,12232,4668,28795
Greenland,2022,11229,15164,4844,31237
Greenland,2023,11502,14214,5039,30755
Greenland,2024,0,0,0,0
Grenada,2005,858,3585,2109,6552
Grenada,2006,858,3208,922,4988
Grenada,2007,985,3388,2058,6431
Grenada,2008,1212,2765,1302,5279
Grenada,2009,0,0,0,0
Grenada,2010,871,7865,1954,10690
Grenada,2011,955,3231,1129,5315
Grenada,2012,941,3415,1380,5736
Grenada,2013,1298,4526,1747,7571
Grenada,2014,1185,3625,1391,6201
Grenada,2015,1117,4207,1747,7071
Grenada,2016,1345,4058,1589,6992
Grenada,2017,1482,6317,2263,10062
Grenada,2018,1880,6553,3547,11980
Grenada,2019,2021,7393,3349,12763
Grenada,2020,1299,6434,4133,11866
Grenada,2021,1319,5952,5344,12615
Grenada,2022,2398,7240,4834,14472
Grenada,2023,2334,7573,5101,15008
Grenada,2024,0,0,0,0
Guam,2005,288,1253,0,1541
Guam,2006,321,1759,14,2094
Guam,2007,257,878,10,1145
Guam,2008,213,841,0,1054
Guam,2009,70,772,0,842
Guam,2010,16,992,0,1008
Guam,2011,82,2120,12,2214
Guam,2012,39,1437,35,1511
Guam,2013,73,996,2,1071
Guam,2014,6,637,2,645
Guam,2015,162,703,6,871
Guam,2016,143,604,0,747
Guam,2017,295,554,8,857
Guam,2018,356,957,21,1334
Guam,2019,529,1187,41,1757
Guam,2020,303,474,95,872
Guam,2021,253,369,479,1101
Guam,2022,1410,2883,462,4755
Guam,2023,1712,3702,1854,7268
Guam,2024,0,0,0,0
Guatemala,2005,63715,110899,44615,219229
Guatemala,2006,42916,90666,50454,184036
Guatemala,2007,79037,114616,55404,249057
Guatemala,2008,71473,96430,56324,224227
Guatemala,2009,59893,81730,59015,200638
Guatemala,2010,65882,89660,71848,227390
Guatemala,2011,69831,95932,88833,254596
Guatemala,2012,62614,100518,99887,263019
Guatemala,2013,73376,101345,101624,276345
Guatemala,2014,82545,101888,102147,286580
Guatemala,2015,107176,126665,143234,377075
Guatemala,2016,96225,120280,141596,358101
Guatemala,2017,102503,133781,153499,389783
Guatemala,2018,117858,138266,152565,408689
Guatemala,2019,117580,139525,165817,422922
Guatemala,2020,83867,117095,269748,470710
Guatemala,2021,147820,154070,245518,547408
Guatemala,2022,170133,171559,281561,623253
Guatemala,2023,166046,171578,280783,618407
Guatemala,2024,188572,172817,286481,647870
Guinea,2005,1778,2754,7430,11962
Guinea,2006,1123,1393,6088,8604
Guinea,2007,1190,1819,6612,9621
Guinea,2008,1880,3671,9194,14745
Guinea,2009,976,4602,27110,32688
Guinea,2010,910,7303,12249,20462
Guinea,2011,967,5588,10643,17198
Guinea,2012,1110,5632,13487,20229
Guinea,2013,1165,4773,44832,50770
Guinea,2014,3741,4948,18453,27142
Guinea,2015,2352,6172,43068,51592
Guinea,2016,2359,8458,23520,34337
Guinea,2017,27909,62347,71794,162050
Guinea,2018,29457,33380,75336,138173
Guinea,2019,42907,25885,73589,142381
Guinea,2020,57030,38225,81473,176728
Guinea,2021,67109,37940,99288,204337
Guinea,2022,73018,58486,103908,235412
Guinea,2023,110504,72598,89956,273058
Guinea,2024,0,0,0,0
Guinea-Bissau,2005,60,51,1229,1340
Guinea-Bissau,2006,0,0,0,0
Guinea-Bissau,2007,0,0,0,0
Guinea-Bissau,2008,0,0,0,0
Guinea-Bissau,2009,0,0,0,0
Guinea-Bissau,2010,0,0,0,0
Guinea-Bissau,2011,0,0,0,0
Guinea-Bissau,2012,0,0,0,0
Guinea-Bissau,2013,39,136,826,1001
Guinea-Bissau,2014,28,108,8052,8188
Guinea-Bissau,2015,51,123,1217,1391
Guinea-Bissau,2016,120,114,1424,1658
Guinea-Bissau,2017,141,177,2031,2349
Guinea-Bissau,2018,135,73,2111,2319
Guinea-Bissau,2019,2086,221,3937,6244
Guinea-Bissau,2020,281,599,4265,5145
Guinea-Bissau,2021,441,648,5564,6653
Guinea-Bissau,2022,481,1353,7241,9075
Guinea-Bissau,2023,717,421,4415,5553
Guinea-Bissau,2024,0,0,0,0
Guyana,2005,1316,2757,7140,11213
Guyana,2006,1581,3579,5323,10483
Guyana,2007,2398,5363,6805,14566
Guyana,2008,2905,4471,7682,15058
Guyana,2009,2597,5748,9104,17449
Guyana,2010,3433,5697,12382,21512
Guyana,2011,3575,6059,11554,21188
Guyana,2012,3832,6473,11554,21859
Guyana,2013,4347,5040,12253,21640
Guyana,2014,4139,4907,12748,21794
Guyana,2015,3112,4999,11315,19426
Guyana,2016,3905,5886,11174,20965
Guyana,2017,6799,8157,14711,29667
Guyana,2018,7680,8808,14835,31323
Guyana,2019,7123,12330,16012,35465
Guyana,2020,3414,7154,11829,22397
Guyana,2021,4608,11625,16797,33030
Guyana,2022,4867,8165,18457,31489
Guyana,2023,6253,10579,15328,32160
Guyana,2024,5876,10096,17231,33203
Haiti,2005,0,0,0,0
Haiti,2006,0,0,0,0
Haiti,2007,0,0,0,0
Haiti,2008,0,0,0,0
Haiti,2009,0,0,0,0
Haiti,2010,0,0,0,0
Haiti,2011,0,0,0,0
Haiti,2012,0,0,0,0
Haiti,2013,22330,17307,41941,81578
Haiti,2014,18797,14364,41431,74592
Haiti,2015,14553,11422,34378,60353
Haiti,2016,12439,9457,35746,57642
Haiti,2017,5826,13490,21514,40830
Haiti,2018,220590,37284,34610,292484
Haiti,2019,279631,27175,46866,353672
Haiti,2020,155746,34555,67861,258162
Haiti,2021,178392,23941,66878,269211
Haiti,2022,149346,19274,63483,232103
Haiti,2023,155943,16199,38829,210971
Haiti,2024,0,0,0,0
Honduras,2005,20466,37056,25681,83203
Honduras,2006,24473,52384,35052,111909
Honduras,2007,31165,57835,42360,131360
Honduras,2008,29529,56785,49359,135673
Honduras,2009,26253,40454,44644,111351
Honduras,2010,35296,48461,57350,141107
Honduras,2011,32481,57241,59643,149365
Honduras,2012,36620,54422,60330,151372
Honduras,2013,32692,42642,61639,136973
Honduras,2014,40032,50771,67315,158118
Honduras,2015,45394,66944,83750,196088
Honduras,2016,43975,68951,96949,209875
Honduras,2017,46959,74085,118316,239360
Honduras,2018,46081,73751,120544,240376
Honduras,2019,48279,78590,118031,244900
Honduras,2020,32550,49881,205913,288344
Honduras,2021,60428,73528,181282,315238
Honduras,2022,0,0,0,0
Honduras,2023,69490,89459,144621,303570
Honduras,2024,77914,102319,132257,312490
"Hong Kong, China",2005,9236458,8018278,403074,17657810
"Hong Kong, China",2006,9477891,8252129,392931,18122951
"Hong Kong, China",2007,9887892,8248824,353951,18490667
"Hong Kong, China",2008,9662127,7901242,382922,17946291
"Hong Kong, China",2009,8211596,6494776,352986,15059358
"Hong Kong, China",2010,8802131,6907138,351959,16061228
"Hong Kong, China",2011,8743890,7346610,384519,16475019
"Hong Kong, China",2012,8117990,7088934,377929,15584853
"Hong Kong, China",2013,8161367,7172045,396683,15730095
"Hong Kong, China",2014,8052045,7027330,391333,15470708
"Hong Kong, China",2015,7318282,6684491,370836,14373609
"Hong Kong, China",2016,6426760,6070546,370210,12867516
"Hong Kong, China",2017,5970395,5708319,333011,12011725
"Hong Kong, China",2018,6121725,5801315,337072,12260112
"Hong Kong, China",2019,5264224,5197654,343422,10805300
"Hong Kong, China",2020,3648921,3588761,687208,7924890
"Hong Kong, China",2021,3911844,4051481,327187,8290512
"Hong Kong, China",2022,3191356,3842549,342806,7376711
"Hong Kong, China",2023,3503853,3408357,234740,7146950
"Hong Kong, China",2024,4642660,3952484,236662,8831806
Hungary,2005,409740,402416,97728,909884
Hungary,2006,390108,442497,116623,949228
Hungary,2007,420738,476931,133062,1030731
Hungary,2008,484835,462993,166967,1114795
Hungary,2009,386410,378734,147209,912353
Hungary,2010,394629,352294,165825,912748
Hungary,2011,532082,499599,212488,1244169
Hungary,2012,452485,406104,207215,1065804
Hungary,2013,520359,447923,258957,1227239
Hungary,2014,613942,503881,248387,1366210
Hungary,2015,566466,449251,215220,1230937
Hungary,2016,645710,491209,249141,1386060
Hungary,2017,793196,602211,273141,1668548
Hungary,2018,996030,714149,293256,2003435
Hungary,2019,930154,658550,303884,1892588
Hungary,2020,990511,606624,607513,2204648
Hungary,2021,1089590,641820,369147,2100557
Hungary,2022,1241584,683791,393423,2318798
Hungary,2023,1151361,687402,366104,2204867
Hungary,2024,1281810,728655,375703,2386168
Iceland,2005,51981,81467,16805,150253
Iceland,2006,59151,84293,16941,160385
Iceland,2007,72990,96740,19881,189611
Iceland,2008,68644,88181,17240,174065
Iceland,2009,45416,51607,10897,107920
Iceland,2010,50738,53585,12664,116987
Iceland,2011,55850,59739,15145,130734
Iceland,2012,47755,59852,14970,122577
Iceland,2013,50848,64451,16276,131575
Iceland,2014,52099,68118,19944,140161
Iceland,2015,46908,62166,21450,130524
Iceland,2016,56517,76659,24076,157252
Iceland,2017,68203,104064,34705,206972
Iceland,2018,78155,96388,28345,202888
Iceland,2019,70170,88525,26399,185094
Iceland,2020,77093,79626,37716,194435
Iceland,2021,112937,102450,38356,253743
Iceland,2022,122313,118953,38813,280079
Iceland,2023,123462,120862,37676,282000
Iceland,2024,119714,114560,38335,272609
India,2005,15451,33452,96468,145371
India,2006,22223,48105,106666,176994
India,2007,33248,67238,113285,213771
India,2008,50302,87408,183019,320729
India,2009,45427,67376,241280,354083
India,2010,74619,101356,267211,443186
India,2011,119370,166449,342706,628525
India,2012,115447,197049,384857,697353
India,2013,158698,257997,388397,805092
India,2014,202963,295492,454993,953448
India,2015,246863,314724,555873,1117460
India,2016,262428,338606,453616,1054650
India,2017,315760,372349,431057,1119166
India,2018,452560,615002,498177,1565739
India,2019,509623,665330,567831,1742784
India,2020,376423,512848,598128,1487399
India,2021,556908,601398,613318,1771624
India,2022,810486,915084,624545,2350115
India,2023,672087,892357,647883,2212327
India,2024,682694,863153,614530,2160377
Indonesia,2005,23090,30148,13003,66241
Indonesia,2006,29986,38767,18614,87367
Indonesia,2007,41227,65309,26144,132680
Indonesia,2008,119710,113218,40073,273001
Indonesia,2009,108000,105838,47869,261707
Indonesia,2010,128102,160523,79530,368155
Indonesia,2011,144228,187875,72502,404605
Indonesia,2012,165870,212770,70568,449208
Indonesia,2013,209687,266708,67393,543788
Indonesia,2014,197696,246734,64258,508688
Indonesia,2015,177906,223613,60612,462131
Indonesia,2016,171830,238703,78125,488658
Indonesia,2017,260265,316675,114954,691894
Indonesia,2018,380345,434854,133309,948508
Indonesia,2019,422106,427616,164502,1014224
Indonesia,2020,295743,331607,308795,936145
Indonesia,2021,325992,311599,328226,965817
Indonesia,2022,285774,300526,246047,832347
Indonesia,2023,271687,267683,162991,702361
Indonesia,2024,275308,268416,122978,666702
"Iran, Islamic Republic of",2005,3356,20280,8508,32144
"Iran, Islamic Republic of",2006,959,3783,1709,6451
"Iran, Islamic Republic of",2007,2154,8045,8137,18336
"Iran, Islamic Republic of",2008,4134,11045,9930,25109
"Iran, Islamic Republic of",2009,5862,10506,13881,30249
"Iran, Islamic Republic of",2010,7550,12393,13109,33052
"Iran, Islamic Republic of",2011,8847,13450,13127,35424
"Iran, Islamic Republic of",2012,7994,11213,7313,26520
"Iran, Islamic Republic of",2013,1636,1635,2224,5495
"Iran, Islamic Republic of",2014,2697,2606,4276,9579
"Iran, Islamic Republic of",2015,7441,6856,4597,18894
"Iran, Islamic Republic of",2016,28522,32825,9129,70476
"Iran, Islamic Republic of",2017,41221,17306,10313,68840
"Iran, Islamic Republic of",2018,12134,2381,2603,17118
"Iran, Islamic Republic of",2019,1086,799,1187,3072
"Iran, Islamic Republic of",2020,511,8982,17556,27049
"Iran, Islamic Republic of",2021,3,3068,736,3807
"Iran, Islamic Republic of",2022,650,2112,949,3711
"Iran, Islamic Republic of",2023,1240,1768,223,3231
"Iran, Islamic Republic of",2024,0,0,0,0
Iraq,2005,0,0,0,0
Iraq,2006,0,0,0,0
Iraq,2007,0,0,0,0
Iraq,2008,0,0,0,0
Iraq,2009,0,0,0,0
Iraq,2010,0,0,0,0
Iraq,2011,0,0,0,0
Iraq,2012,0,0,0,0
Iraq,2013,0,0,0,0
Iraq,2014,28328,12897,38845,80070
Iraq,2015,957998,655287,411991,2025276
Iraq,2016,939011,644464,370442,1953917
Iraq,2017,1199920,741261,442142,2383323
Iraq,2018,1024146,589753,359574,1973473
Iraq,2019,984300,594910,419817,1999027
Iraq,2020,919331,572379,475718,1967428
Iraq,2021,802831,580231,395408,1778470
Iraq,2022,840832,676014,428714,1945560
Iraq,2023,876693,715277,406785,1998755
Iraq,2024,0,0,0,0
Ireland,2005,872581,974367,194251,2041199
Ireland,2006,952634,1025363,222900,2200897
Ireland,2007,1161116,1225818,269515,2656449
Ireland,2008,1190588,1223806,234058,2648452
Ireland,2009,1141551,1053944,206698,2402193
Ireland,2010,1111764,981568,187341,2280673
Ireland,2011,1168890,1038819,202489,2410198
Ireland,2012,1030434,1000951,184724,2216109
Ireland,2013,991803,925809,195167,2112779
Ireland,2014,1087473,993815,219217,2300505
Ireland,2015,1007240,965721,212152,2185113
Ireland,2016,1028232,958643,216424,2203299
Ireland,2017,1031662,951081,252072,2234815
Ireland,2018,1140257,1055566,278867,2474690
Ireland,2019,1145068,1022160,272668,2439896
Ireland,2020,1119030,1192919,593957,2905906
Ireland,2021,1570316,1319874,374524,3264714
Ireland,2022,1640551,1402352,372096,3414999
Ireland,2023,1538727,1401308,338336,3278371
Ireland,2024,1714860,1408452,364202,3487514
Israel,2005,263097,376935,93388,733420
Israel,2006,323502,416185,99842,839529
Israel,2007,387533,500875,121803,1010211
Israel,2008,491766,562740,140682,1195188
Israel,2009,456034,493901,123674,1073609
Israel,2010,495789,563012,149391,1208192
Israel,2011,624622,654387,166689,1445698
Israel,2012,715078,645281,173837,1534196
Israel,2013,774497,691594,185118,1651209
Israel,2014,817584,778642,219624,1815850
Israel,2015,815110,723115,207391,1745616
Israel,2016,917647,693138,218653,1829438
Israel,2017,982956,742977,233108,1959041
Israel,2018,1067411,797732,250779,2115922
Israel,2019,1053379,861467,257825,2172671
Israel,2020,953888,805247,557911,2317046
Israel,2021,1341396,1035742,398375,2775513
Israel,2022,1511481,1181660,384693,3077834
Israel,2023,1077214,939514,290435,2307163
Israel,2024,1383122,1211880,363540,2958542
Italy,2005,5198077,6394676,872758,12465511
Italy,2006,6154159,7235044,969101,14358304
Italy,2007,7250284,7840806,1114721,16205811
Italy,2008,8150151,8447216,1176049,17773416
Italy,2009,7356990,7474100,1037451,15868541
Italy,2010,7760018,7749121,1167089,16676228
Italy,2011,8854477,8740964,1372391,18967832
Italy,2012,7567568,7411048,1117010,16095626
Italy,2013,7601487,7314645,1210718,16126850
Italy,2014,8260367,7983543,1312450,17556360
Italy,2015,7390737,7155431,1155861,15702029
Italy,2016,7561884,7118935,1249257,15930076
Italy,2017,8029483,7188795,1283342,16501620
Italy,2018,8594069,8242167,1321449,18157685
Italy,2019,8143638,8265314,1269290,17678242
Italy,2020,6906848,7504374,4516511,18927733
Italy,2021,8556080,7734167,1961315,18251562
Italy,2022,10293116,9306280,1929962,21529358
Italy,2023,10022138,9658123,1578459,21258720
Italy,2024,9786011,9230415,1557567,20573993
Jamaica,2005,16536,47900,21192,85628
Jamaica,2006,19060,46098,23492,88650
Jamaica,2007,16996,45199,27264,89459
Jamaica,2008,19407,45612,36709,101728
Jamaica,2009,16013,39742,24861,80616
Jamaica,2010,15183,42441,31947,89571
Jamaica,2011,14366,41107,26899,82372
Jamaica,2012,13071,35720,24141,72932
Jamaica,2013,11686,31372,21611,64669
Jamaica,2014,12524,30400,27125,70049
Jamaica,2015,11753,29052,27071,67876
Jamaica,2016,8788,36330,30766,75884
Jamaica,2017,14201,42127,34404,90732
Jamaica,2018,13854,43118,36446,93418
Jamaica,2019,14463,45380,37649,97492
Jamaica,2020,8902,31483,34096,74481
Jamaica,2021,10304,34399,29698,74401
Jamaica,2022,17146,37360,33795,88301
Jamaica,2023,20875,48775,33064,102714
Jamaica,2024,0,0,0,0
Japan,2005,9785815,11380755,2233083,23399653
Japan,2006,10377968,12050454,2395380,24823802
Japan,2007,10755334,11842215,2404838,25002387
Japan,2008,11743171,12473169,2751342,26967682
Japan,2009,11974511,12095315,3411932,27481758
Japan,2010,12644529,12624650,3029069,28298248
Japan,2011,15223586,15887353,3784603,34895542
Japan,2012,15635886,16411345,3857210,35904441
Japan,2013,15683593,16099773,3782749,35566115
Japan,2014,14576466,14788452,3749290,33114208
Japan,2015,13314721,13524669,3436903,30276293
Japan,2016,12939183,13359822,3422573,29721578
Japan,2017,12810747,13563272,3503393,29877412
Japan,2018,13781060,14708493,3721414,32210967
Japan,2019,13663490,14301882,3822467,31787839
Japan,2020,11989270,11964712,7513614,31467596
Japan,2021,12532298,11316919,4693402,28542619
Japan,2022,13157446,12146026,4845679,30149151
Japan,2023,12086253,11738764,3986564,27811581
Japan,2024,11902278,11015651,3669592,26587521
Jordan,2005,58777,100504,21033,180314
Jordan,2006,64887,173388,22969,261244
Jordan,2007,85019,201151,26371,312541
Jordan,2008,90745,225991,30114,346850
Jordan,2009,88879,198791,29453,317123
Jordan,2010,106058,168260,29987,304305
Jordan,2011,130656,178227,34261,343144
Jordan,2012,183131,135691,54399,373221
Jordan,2013,241180,148100,87409,476689
Jordan,2014,243008,136395,67944,447347
Jordan,2015,280065,107482,54528,442075
Jordan,2016,326419,101014,57298,484731
Jordan,2017,318978,88191,43381,450550
Jordan,2018,297821,78900,43238,419959
Jordan,2019,265198,78883,41716,385797
Jordan,2020,265650,69380,53526,388556
Jordan,2021,332885,79311,52778,464974
Jordan,2022,348556,116941,62868,528365
Jordan,2023,346801,128074,61731,536606
Jordan,2024,0,0,0,0
Kazakhstan,2005,20682,44139,29713,94534
Kazakhstan,2006,24952,46648,41176,112776
Kazakhstan,2007,39671,72711,44949,157331
Kazakhstan,2008,46963,85041,63533,195537
Kazakhstan,2009,42243,77075,46120,165438
Kazakhstan,2010,56856,86875,43194,186925
Kazakhstan,2011,111473,169853,73655,354981
Kazakhstan,2012,245930,393776,121573,761279
Kazakhstan,2013,410754,486939,133645,1031338
Kazakhstan,2014,400502,520233,134738,1055473
Kazakhstan,2015,250654,314274,87602,652530
Kazakhstan,2016,197783,224903,69675,492361
Kazakhstan,2017,217196,247901,86526,551623
Kazakhstan,2018,237685,274682,118577,630944
Kazakhstan,2019,318058,352517,162681,833256
Kazakhstan,2020,306069,320285,224182,850536
Kazakhstan,2021,478881,396014,190013,1064908
Kazakhstan,2022,849850,813850,261032,1924732
Kazakhstan,2023,1659373,1800643,529262,3989278
Kazakhstan,2024,1192077,1002937,507821,2702835
Kenya,2005,6408,11088,61877,79373
Kenya,2006,15593,16774,88922,121289
Kenya,2007,20526,31228,88560,140314
Kenya,2008,16290,25946,93344,135580
Kenya,2009,15545,21647,107631,144823
Kenya,2010,17759,34466,142199,194424
Kenya,2011,10994,29915,187330,228239
Kenya,2012,14236,28788,172283,215307
Kenya,2013,13075,34199,146689,193963
Kenya,2014,13788,30694,185589,230071
Kenya,2015,13119,17884,201141,232144
Kenya,2016,21366,34907,188038,244311
Kenya,2017,28933,82931,215540,327404
Kenya,2018,47878,94083,234927,376888
Kenya,2019,39907,92748,235837,368492
Kenya,2020,31087,100797,196836,328720
Kenya,2021,37687,113540,287574,438801
Kenya,2022,56414,96076,259599,412089
Kenya,2023,49121,94013,285110,428244
Kenya,2024,56182,104576,296796,457554
Kiribati,2005,336,159,298,793
Kiribati,2006,0,0,0,0
Kiribati,2007,421,131,481,1033
Kiribati,2008,344,152,295,791
Kiribati,2009,385,76,424,885
Kiribati,2010,354,124,493,971
Kiribati,2011,277,82,725,1084
Kiribati,2012,331,81,879,1291
Kiribati,2013,329,128,603,1060
Kiribati,2014,519,523,808,1850
Kiribati,2015,395,472,741,1608
Kiribati,2016,552,575,741,1868
Kiribati,2017,511,359,871,1741
Kiribati,2018,338,310,664,1312
Kiribati,2019,0,0,0,0
Kiribati,2020,387,410,722,1519
Kiribati,2021,1019,1024,2408,4451
Kiribati,2022,942,866,1049,2857
Kiribati,2023,730,539,703,1972
Kiribati,2024,0,0,0,0
"Korea, Democratic People's Republic of",2005,8017,6251,5923,20191
"Korea, Democratic People's Republic of",2006,11603,7686,4952,24241
"Korea, Democratic People's Republic of",2007,25654,5368,11522,42544
"Korea, Democratic People's Republic of",2008,91454,48865,16679,156998
"Korea, Democratic People's Republic of",2009,97984,28912,34917,161813
"Korea, Democratic People's Republic of",2010,49397,12526,15357,77280
"Korea, Democratic People's Republic of",2011,53403,10471,15181,79055
"Korea, Democratic People's Republic of",2012,66490,15312,24743,106545
"Korea, Democratic People's Republic of",2013,87467,24871,20462,132800
"Korea, Democratic People's Republic of",2014,115479,40802,38884,195165
"Korea, Democratic People's Republic of",2015,98711,35557,31410,165678
"Korea, Democratic People's Republic of",2016,128695,52026,32204,212925
"Korea, Democratic People's Republic of",2017,119745,45204,40181,205130
"Korea, Democratic People's Republic of",2018,74671,24512,39185,138368
"Korea, Democratic People's Republic of",2019,89794,34163,46602,170559
"Korea, Democratic People's Republic of",2020,4759,1599,3588,9946
"Korea, Democratic People's Republic of",2021,584,76,3878,4538
"Korea, Democratic People's Republic of",2022,9901,5878,14626,30405
"Korea, Democratic People's Republic of",2023,59429,31988,25282,116699
"Korea, Democratic People's Republic of",2024,0,0,0,0
"Korea, Republic of",2005,851896,1867241,238641,2957778
"Korea, Republic of",2006,1049479,2443854,296987,3790320
"Korea, Republic of",2007,1266042,2818544,332440,4417026
"Korea, Republic of",2008,1273124,2720180,356209,4349513
"Korea, Republic of",2009,1022218,2139441,324307,3485966
"Korea, Republic of",2010,1320817,2803329,411219,4535365
"Korea, Republic of",2011,1777039,3944973,547764,6269776
"Korea, Republic of",2012,1897173,4006493,577727,6481393
"Korea, Republic of",2013,2234814,4894062,671495,7800371
"Korea, Republic of",2014,2460508,5572166,735594,8768268
"Korea, Republic of",2015,2684577,5370849,727683,8783109
"Korea, Republic of",2016,2895800,5272564,719128,8887492
"Korea, Republic of",2017,3123794,5662554,807760,9594108
"Korea, Republic of",2018,3631354,6540249,944323,11115926
"Korea, Republic of",2019,3909356,6489731,964571,11363658
"Korea, Republic of",2020,3697125,5387534,1546643,10631302
"Korea, Republic of",2021,4382114,6151644,1379757,11913515
"Korea, Republic of",2022,5047164,7203142,1371878,13622184
"Korea, Republic of",2023,4842235,7149304,1247606,13239145
"Korea, Republic of",2024,5083080,7283947,1316291,13683318
Kuwait,2005,0,0,0,0
Kuwait,2006,120356,475700,70582,666638
Kuwait,2007,140694,530392,75295,746381
Kuwait,2008,198253,511895,73159,783307
Kuwait,2009,168895,551422,63887,784204
Kuwait,2010,173991,549679,61728,785398
Kuwait,2011,129178,750771,78519,958468
Kuwait,2012,196466,796110,98082,1090658
Kuwait,2013,188472,884365,99128,1171965
Kuwait,2014,527417,603221,102399,1233037
Kuwait,2015,526912,570415,96855,1194182
Kuwait,2016,441666,565738,91047,1098451
Kuwait,2017,519446,531273,103023,1153742
Kuwait,2018,574985,558106,104910,1238001
Kuwait,2019,582598,550406,97720,1230724
Kuwait,2020,577235,520927,332911,1431073
Kuwait,2021,927859,666882,247481,1842222
Kuwait,2022,956309,593075,115047,1664431
Kuwait,2023,844690,602110,91684,1538484
Kuwait,2024,0,0,0,0
Kyrgyzstan,2005,4061,4560,4826,13447
Kyrgyzstan,2006,7966,6505,4738,19209
Kyrgyzstan,2007,2888,4972,4764,12624
Kyrgyzstan,2008,83992,62629,15335,161956
Kyrgyzstan,2009,49044,54565,13912,117521
Kyrgyzstan,2010,51825,62535,19839,134199
Kyrgyzstan,2011,71979,106806,17273,196058
Kyrgyzstan,2012,117345,112083,28587,258015
Kyrgyzstan,2013,124136,99739,27665,251540
Kyrgyzstan,2014,98416,84890,33018,216324
Kyrgyzstan,2015,66941,64933,19199,151073
Kyrgyzstan,2016,151328,102009,24530,277867
Kyrgyzstan,2017,156798,97158,18472,272428
Kyrgyzstan,2018,235111,130561,19046,384718
Kyrgyzstan,2019,144314,68065,17265,229644
Kyrgyzstan,2020,58017,32841,20691,111549
Kyrgyzstan,2021,269476,95200,30783,395459
Kyrgyzstan,2022,311382,113301,42198,466881
Kyrgyzstan,2023,144725,44491,48069,237285
Kyrgyzstan,2024,0,0,0,0
Lao People's Democratic Republic,2005,0,0,0,0
Lao People's Democratic Republic,2006,0,0,0,0
Lao People's Democratic Republic,2007,0,0,0,0
Lao People's Democratic Republic,2008,0,0,0,0
Lao People's Democratic Republic,2009,0,0,0,0
Lao People's Democratic Republic,2010,731,3022,4283,8036
Lao People's Democratic Republic,2011,290,2806,3773,6869
Lao People's Democratic Republic,2012,2754,2525,4325,9604
Lao People's Democratic Republic,2013,4233,5700,6734,16667
Lao People's Democratic Republic,2014,3109,12538,5834,21481
Lao People's Democratic Republic,2015,1852,8757,4104,14713
Lao People's Democratic Republic,2016,1809,11777,9083,22669
Lao People's Democratic Republic,2017,2916,11178,12966,27060
Lao People's Democratic Republic,2018,3945,13954,8575,26474
Lao People's Democratic Republic,2019,5463,10252,10394,26109
Lao People's Democratic Republic,2020,4706,10671,15035,30412
Lao People's Democratic Republic,2021,4196,10141,16941,31278
Lao People's Democratic Republic,2022,42458,39495,46247,128200
Lao People's Democratic Republic,2023,30053,15388,49154,94595
Lao People's Democratic Republic,2024,0,0,0,0
Latvia,2005,67332,100066,27521,194919
Latvia,2006,96377,128400,39559,264336
Latvia,2007,128576,177925,52555,359056
Latvia,2008,135161,178128,64584,377873
Latvia,2009,118865,129937,48389,297191
Latvia,2010,121627,126251,53236,301114
Latvia,2011,164754,181199,65658,411611
Latvia,2012,167937,215940,69967,453844
Latvia,2013,178002,271215,71808,521025
Latvia,2014,180342,253393,75656,509391
Latvia,2015,148984,165416,58433,372833
Latvia,2016,139866,165647,60892,366405
Latvia,2017,143556,172043,74014,389613
Latvia,2018,151820,188742,85475,426037
Latvia,2019,179700,199649,89053,468402
Latvia,2020,180896,207328,133136,521360
Latvia,2021,225060,245377,104135,574572
Latvia,2022,253667,252565,105492,611724
Latvia,2023,274993,265689,96877,637559
Latvia,2024,293292,278681,89499,661472
Lebanon,2005,98292,168028,20772,287092
Lebanon,2006,101003,170564,19003,290570
Lebanon,2007,111206,174044,22665,307915
Lebanon,2008,131817,227105,31008,389930
Lebanon,2009,156568,240431,42165,439164
Lebanon,2010,159672,254061,41951,455684
Lebanon,2011,164226,274647,37078,475951
Lebanon,2012,190429,282943,41290,514662
Lebanon,2013,197323,281980,51423,530726
Lebanon,2014,203119,304566,55102,562787
Lebanon,2015,212051,319607,49499,581157
Lebanon,2016,203683,312397,48909,564989
Lebanon,2017,200175,321292,51331,572798
Lebanon,2018,196952,306809,51268,555029
Lebanon,2019,173096,241370,37754,452220
Lebanon,2020,64040,79213,35295,178548
Lebanon,2021,73855,88874,43296,206025
Lebanon,2022,122580,132367,44242,299189
Lebanon,2023,170015,157804,39388,367207
Lebanon,2024,0,0,0,0
Lesotho,2005,20138,4401,5766,30305
Lesotho,2006,33140,9802,8457,51399
Lesotho,2007,39749,2606,8142,50497
Lesotho,2008,14698,7230,5486,27414
Lesotho,2009,14316,5549,6834,26699
Lesotho,2010,22401,20442,12226,55069
Lesotho,2011,15210,18913,9461,43584
Lesotho,2012,19505,16888,7991,44384
Lesotho,2013,110512,19477,8703,138692
Lesotho,2014,45357,23533,8521,77411
Lesotho,2015,17837,34737,6476,59050
Lesotho,2016,17017,34828,7743,59588
Lesotho,2017,24317,34199,9396,67912
Lesotho,2018,18384,26628,8033,53045
Lesotho,2019,16339,31460,6702,54501
Lesotho,2020,16015,28352,8810,53177
Lesotho,2021,22376,51462,10028,83866
Lesotho,2022,18675,38255,10771,67701
Lesotho,2023,16765,28354,8970,54089
Lesotho,2024,0,0,0,0
Liberia,2005,0,0,0,0
Liberia,2006,0,0,0,0
Liberia,2007,0,0,0,0
Liberia,2008,0,0,0,0
Liberia,2009,0,0,0,0
Liberia,2010,0,0,0,0
Liberia,2011,0,0,0,0
Liberia,2012,0,0,0,0
Liberia,2013,0,0,0,0
Liberia,2014,0,0,0,0
Liberia,2015,0,0,0,0
Liberia,2016,0,0,0,0
Liberia,2017,3569,1587,21717,26873
Liberia,2018,2253,1684,29950,33887
Liberia,2019,2327,1696,20949,24972
Liberia,2020,1590,1347,23343,26280
Liberia,2021,2144,1244,35538,38926
Liberia,2022,1437,3002,27038,31477
Liberia,2023,1487,3071,32927,37485
Liberia,2024,0,0,0,0
"Libya, State of",2005,0,0,0,0
"Libya, State of",2006,0,0,0,0
"Libya, State of",2007,15833,104024,31102,150959
"Libya, State of",2008,43358,70399,28873,142630
"Libya, State of",2009,42288,109117,29617,181022
"Libya, State of",2010,49087,89925,38480,177492
"Libya, State of",2011,0,0,0,0
"Libya, State of",2012,0,0,0,0
"Libya, State of",2013,0,0,0,0
"Libya, State of",2014,0,0,0,0
"Libya, State of",2015,359252,259700,106962,725914
"Libya, State of",2016,219286,186800,52141,458227
"Libya, State of",2017,195597,161144,48529,405270
"Libya, State of",2018,246212,222619,66262,535093
"Libya, State of",2019,353670,277656,95692,727018
"Libya, State of",2020,264768,220507,110639,595914
"Libya, State of",2021,289368,202055,115007,606430
"Libya, State of",2022,317466,234089,92329,643884
"Libya, State of",2023,352124,301938,115731,769793
"Libya, State of",2024,0,0,0,0
Lithuania,2005,72196,102713,48357,223266
Lithuania,2006,107754,147006,59858,314618
Lithuania,2007,151645,232226,74590,458461
Lithuania,2008,261814,266977,89097,617888
Lithuania,2009,212961,180988,77130,471079
Lithuania,2010,210405,192050,80358,482813
Lithuania,2011,247413,221069,88973,557455
Lithuania,2012,183514,236287,110218,530019
Lithuania,2013,192743,271149,129960,593852
Lithuania,2014,230761,303532,128281,662574
Lithuania,2015,206184,265522,110504,582210
Lithuania,2016,241282,286781,132037,660100
Lithuania,2017,269692,325340,152668,747700
Lithuania,2018,287330,310986,179048,777364
Lithuania,2019,271606,301691,171446,744743
Lithuania,2020,254058,304594,273740,832392
Lithuania,2021,337060,354619,218645,910324
Lithuania,2022,356489,362746,200453,919688
Lithuania,2023,378097,394087,204316,976500
Lithuania,2024,317059,351731,178054,846844
Luxembourg,2005,143764,202659,38264,384687
Luxembourg,2006,154178,213752,37620,405550
Luxembourg,2007,179417,216920,48028,444365
Luxembourg,2008,221096,273680,53680,548456
Luxembourg,2009,212664,248951,49571,511186
Luxembourg,2010,203679,245393,49459,498531
Luxembourg,2011,222191,278850,55763,556804
Luxembourg,2012,204815,254776,48381,507972
Luxembourg,2013,209893,272406,56150,538449
Luxembourg,2014,212053,286873,54246,553172
Luxembourg,2015,172803,258165,45903,476871
Luxembourg,2016,165763,227797,42026,435586
Luxembourg,2017,172162,199835,43360,415357
Luxembourg,2018,184669,204776,48685,438130
Luxembourg,2019,192484,212799,49536,454819
Luxembourg,2020,166239,201650,162466,530355
Luxembourg,2021,200992,215572,62938,479502
Luxembourg,2022,202621,202024,51724,456369
Luxembourg,2023,193530,206974,48973,449477
Luxembourg,2024,198847,209259,46860,454966
"Macao, China",2005,238753,182519,3156,424428
"Macao, China",2006,268202,166509,4802,439513
"Macao, China",2007,280040,185531,9619,475190
"Macao, China",2008,217218,179235,7960,404413
"Macao, China",2009,83614,94110,13966,191690
"Macao, China",2010,92342,119606,5276,217224
"Macao, China",2011,115105,181609,8621,305335
"Macao, China",2012,129560,199211,8993,337764
"Macao, China",2013,155724,228204,9016,392944
"Macao, China",2014,184523,263069,10067,457659
"Macao, China",2015,179802,285913,17047,482762
"Macao, China",2016,184819,300061,12908,497788
"Macao, China",2017,221174,280418,15762,517354
"Macao, China",2018,311030,284818,17106,612954
"Macao, China",2019,344694,345858,27302,717854
"Macao, China",2020,390722,294818,60177,745717
"Macao, China",2021,657269,513114,29946,1200329
"Macao, China",2022,621794,450603,41305,1113702
"Macao, China",2023,630605,465890,29351,1125846
"Macao, China",2024,0,0,0,0
"Macedonia, North",2005,23906,41006,3648,68560
"Macedonia, North",2006,17040,36403,4124,57567
"Macedonia, North",2007,24691,47152,6007,77850
"Macedonia, North",2008,29702,52253,9011,90966
"Macedonia, North",2009,27491,39884,8196,75571
"Macedonia, North",2010,24788,32705,8138,65631
"Macedonia, North",2011,26389,30929,8826,66144
"Macedonia, North",2012,24916,31480,8157,64553
"Macedonia, North",2013,31069,34481,9768,75318
"Macedonia, North",2014,32540,40135,11196,83871
"Macedonia, North",2015,29983,37233,16538,83754
"Macedonia, North",2016,34693,43422,14509,92624
"Macedonia, North",2017,36574,47340,13736,97650
"Macedonia, North",2018,43290,52843,14896,111029
"Macedonia, North",2019,44887,54549,15029,114465
"Macedonia, North",2020,44477,48495,22777,115749
"Macedonia, North",2021,60572,64355,21493,146420
"Macedonia, North",2022,70125,74297,19828,164250
"Macedonia, North",2023,71545,80338,18228,170111
"Macedonia, North",2024,88327,87463,27514,203304
Madagascar,2005,1615,2738,8838,13191
Madagascar,2006,1880,5396,23068,30344
Madagascar,2007,3488,6913,42870,53271
Madagascar,2008,4048,7161,28400,39609
Madagascar,2009,3270,4264,36917,44451
Madagascar,2010,2714,5049,48413,56176
Madagascar,2011,3438,6882,35285,45605
Madagascar,2012,4685,4301,47611,56597
Madagascar,2013,9717,5062,47503,62282
Madagascar,2014,3678,7517,47953,59148
Madagascar,2015,5237,6169,62094,73500
Madagascar,2016,10064,9992,53296,73352
Madagascar,2017,8265,27141,71504,106910
Madagascar,2018,15599,48713,87438,151750
Madagascar,2019,12794,45730,75242,133766
Madagascar,2020,9450,28987,70804,109241
Madagascar,2021,10122,34375,92929,137426
Madagascar,2022,9747,23536,101888,135171
Madagascar,2023,12896,15363,88363,116622
Madagascar,2024,12318,19937,128290,160545
Malawi,2005,2244,6443,26248,34935
Malawi,2006,1793,6918,18778,27489
Malawi,2007,2300,6356,19856,28512
Malawi,2008,2871,7142,27253,37266
Malawi,2009,3859,11371,33578,48808
Malawi,2010,4130,14321,36493,54944
Malawi,2011,5382,12921,63238,81541
Malawi,2012,3391,11203,51918,66512
Malawi,2013,5885,8528,56811,71224
Malawi,2014,5452,8830,67973,82255
Malawi,2015,4642,5995,101446,112083
Malawi,2016,4638,5963,49839,60440
Malawi,2017,5025,7148,59189,71362
Malawi,2018,10118,14216,89214,113548
Malawi,2019,6000,14629,71887,92516
Malawi,2020,10987,14930,93150,119067
Malawi,2021,5398,10393,131342,147133
Malawi,2022,6966,10261,102574,119801
Malawi,2023,9652,13014,114034,136700
Malawi,2024,0,0,0,0
Malaysia,2005,100000,144682,124454,369136
Malaysia,2006,120326,192528,131619,444473
Malaysia,2007,162546,203313,148397,514256
Malaysia,2008,180847,236388,172911,590146
Malaysia,2009,119467,153978,161822,435267
Malaysia,2010,135362,174237,181122,490721
Malaysia,2011,227342,332612,231254,791208
Malaysia,2012,310415,380468,257248,948131
Malaysia,2013,298534,585424,299858,1183816
Malaysia,2014,486353,459635,320666,1266654
Malaysia,2015,1109277,727576,386407,2223260
Malaysia,2016,1100522,798797,436953,2336272
Malaysia,2017,899616,683219,482759,2065594
Malaysia,2018,1012749,717396,515154,2245299
Malaysia,2019,860105,650535,418018,1928658
Malaysia,2020,644838,473130,679725,1797693
Malaysia,2021,759282,447988,502042,1709312
Malaysia,2022,1373628,685443,488317,2547388
Malaysia,2023,1163118,629847,402713,2195678
Malaysia,2024,1399083,739002,467169,2605254
Maldives,2005,4334,1237,4987,10558
Maldives,2006,5855,1787,7180,14822
Maldives,2007,7903,1818,7530,17251
Maldives,2008,10486,1917,8548,20951
Maldives,2009,9305,1913,7631,18849
Maldives,2010,10622,2021,7737,20380
Maldives,2011,10701,2932,9804,23437
Maldives,2012,14557,3870,9302,27729
Maldives,2013,17224,4106,11942,33272
Maldives,2014,16403,4186,13844,34433
Maldives,2015,17418,3907,14042,35367
Maldives,2016,17620,3790,17500,38910
Maldives,2017,19623,4410,16528,40561
Maldives,2018,22466,5333,20923,48722
Maldives,2019,23721,7240,20041,51002
Maldives,2020,11746,6582,18069,36397
Maldives,2021,24301,10654,21335,56290
Maldives,2022,28317,12379,23753,64449
Maldives,2023,26690,11759,27290,65739
Maldives,2024,0,0,0,0
Mali,2005,9174,1385,10117,20676
Mali,2006,10935,2088,12032,25055
Mali,2007,10425,1419,36436,48280
Mali,2008,11542,8661,33951,54154
Mali,2009,0,0,0,0
Mali,2010,11141,9818,33091,54050
Mali,2011,7339,5826,22476,35641
Mali,2012,7032,5141,27415,39588
Mali,2013,0,0,0,0
Mali,2014,0,0,0,0
Mali,2015,0,0,0,0
Mali,2016,8373,5293,31155,44821
Mali,2017,9753,4357,32604,46714
Mali,2018,10919,5329,32201,48449
Mali,2019,9949,5806,39196,54951
Mali,2020,9048,5965,44750,59763
Mali,2021,13894,7415,46879,68188
Mali,2022,8228,4448,29606,42282
Mali,2023,4556,19025,53313,76894
Mali,2024,0,0,0,0
Malta,2005,46025,61394,10248,117667
Malta,2006,50450,56469,9133,116052
Malta,2007,55785,59432,10465,125682
Malta,2008,54636,67976,13290,135902
Malta,2009,44908,58752,11448,115108
Malta,2010,49670,50131,10763,110564
Malta,2011,46625,50823,12746,110194
Malta,2012,46391,41894,10919,99204
Malta,2013,50414,43749,11641,105804
Malta,2014,58030,49328,12998,120356
Malta,2015,60923,49860,13139,123922
Malta,2016,54000,45080,14152,113232
Malta,2017,60652,58076,14858,133586
Malta,2018,77786,61246,14901,153933
Malta,2019,90099,62052,14415,166566
Malta,2020,70460,65084,30910,166454
Malta,2021,78610,52558,19935,151103
Malta,2022,83319,72163,21652,177134
Malta,2023,117970,89212,19901,227083
Malta,2024,98103,67860,23465,189428
Marshall Islands,2005,141,182,286,609
Marshall Islands,2006,138,243,111,492
Marshall Islands,2007,606,385,226,1217
Marshall Islands,2008,553,278,216,1047
Marshall Islands,2009,187,132,200,519
Marshall Islands,2010,1657,171,226,2054
Marshall Islands,2011,310,490,240,1040
Marshall Islands,2012,307,544,201,1052
Marshall Islands,2013,323,180,234,737
Marshall Islands,2014,494,449,486,1429
Marshall Islands,2015,781,398,507,1686
Marshall Islands,2016,403,543,1865,2811
Marshall Islands,2017,575,630,266,1471
Marshall Islands,2018,368,598,245,1211
Marshall Islands,2019,377,602,304,1283
Marshall Islands,2020,566,980,1378,2924
Marshall Islands,2021,731,1046,442,2219
Marshall Islands,2022,927,1029,1119,3075
Marshall Islands,2023,1035,1568,909,3512
Marshall Islands,2024,0,0,0,0
Mauritania,2005,273,2048,2362,4683
Mauritania,2006,0,0,0,0
Mauritania,2007,2142,4024,5664,11830
Mauritania,2008,876,5455,6668,12999
Mauritania,2009,797,6319,5853,12969
Mauritania,2010,699,4697,9208,14604
Mauritania,2011,811,8425,12404,21640
Mauritania,2012,1824,7616,16276,25716
Mauritania,2013,3191,8443,13509,25143
Mauritania,2014,2074,13502,13111,28687
Mauritania,2015,1485,7664,16089,25238
Mauritania,2016,2502,9699,20538,32739
Mauritania,2017,2475,11125,23409,37009
Mauritania,2018,2938,39993,30402,73333
Mauritania,2019,3995,10204,19630,33829
Mauritania,2020,3862,7545,15140,26547
Mauritania,2021,2727,11243,14380,28350
Mauritania,2022,4452,9390,11853,25695
Mauritania,2023,3499,11690,15715,30904
Mauritania,2024,4623,9481,15216,29320
Mauritius,2005,8320,27405,6543,42268
Mauritius,2006,7190,25377,8138,40705
Mauritius,2007,9710,29605,7853,47168
Mauritius,2008,13014,39002,12773,64789
Mauritius,2009,11409,32473,9291,53173
Mauritius,2010,14476,40538,10884,65898
Mauritius,2011,23042,49591,12096,84729
Mauritius,2012,25634,53072,12744,91450
Mauritius,2013,23977,50383,15711,90071
Mauritius,2014,25177,56654,16715,98546
Mauritius,2015,18308,45706,13197,77211
Mauritius,2016,22694,45494,17758,85946
Mauritius,2017,26924,48499,19399,94822
Mauritius,2018,28630,55437,18271,102338
Mauritius,2019,41128,58858,19563,119549
Mauritius,2020,27519,44317,32905,104741
Mauritius,2021,39922,52220,24692,116834
Mauritius,2022,44857,65937,26283,137077
Mauritius,2023,37405,71480,22023,130908
Mauritius,2024,41182,77617,27183,145982
Mayotte,2005,1754,2556,1742,6052
Mayotte,2006,2550,3049,1924,7523
Mayotte,2007,2830,3357,2118,8305
Mayotte,2008,3810,3419,2495,9724
Mayotte,2009,3015,3023,2381,8419
Mayotte,2010,1858,3150,1321,6329
Mayotte,2011,2405,3038,1947,7390
Mayotte,2012,2091,2553,2800,7444
Mayotte,2013,10637,2490,2346,15473
Mayotte,2014,0,0,0,0
Mayotte,2015,0,0,0,0
Mayotte,2016,0,0,0,0
Mayotte,2017,0,0,0,0
Mayotte,2018,0,0,0,0
Mayotte,2019,0,0,0,0
Mayotte,2020,0,0,0,0
Mayotte,2021,0,0,0,0
Mayotte,2022,0,0,0,0
Mayotte,2023,0,0,0,0
Mayotte,2024,0,0,0,0
Mexico,2005,1184628,1134526,244615,2563769
Mexico,2006,1235912,1112811,290196,2638919
Mexico,2007,1158158,1132549,356947,2647654
Mexico,2008,1172253,1174061,369415,2715729
Mexico,2009,982581,965272,374181,2322034
Mexico,2010,1101554,983027,401395,2485976
Mexico,2011,1320867,1176309,475816,2972992
Mexico,2012,1427523,1258997,520745,3207265
Mexico,2013,1581752,1369012,562763,3513527
Mexico,2014,1745819,1532955,618270,3897044
Mexico,2015,1864370,1597404,578303,4040077
Mexico,2016,1825974,1598725,623506,4048205
Mexico,2017,1766548,1560789,644100,3971437
Mexico,2018,2019908,1755339,698502,4473749
Mexico,2019,2125944,1821051,764979,4711974
Mexico,2020,1755536,1281730,1128389,4165655
Mexico,2021,2599222,1632592,996900,5228714
Mexico,2022,3470404,2330343,1036025,6836772
Mexico,2023,3636849,2614794,1046497,7298140
Mexico,2024,0,0,0,0
"Micronesia, Federated States of",2005,620,1704,685,3009
"Micronesia, Federated States of",2006,448,1728,623,2799
"Micronesia, Federated States of",2007,414,1956,765,3135
"Micronesia, Federated States of",2008,450,1573,679,2702
"Micronesia, Federated States of",2009,326,1577,699,2602
"Micronesia, Federated States of",2010,345,1465,754,2564
"Micronesia, Federated States of",2011,293,1626,617,2536
"Micronesia, Federated States of",2012,267,1695,738,2700
"Micronesia, Federated States of",2013,224,1225,684,2133
"Micronesia, Federated States of",2014,169,719,373,1261
"Micronesia, Federated States of",2015,170,1079,615,1864
"Micronesia, Federated States of",2016,206,268,534,1008
"Micronesia, Federated States of",2017,202,202,391,795
"Micronesia, Federated States of",2018,223,308,497,1028
"Micronesia, Federated States of",2019,162,137,471,770
"Micronesia, Federated States of",2020,178,822,1397,2397
"Micronesia, Federated States of",2021,394,326,853,1573
"Micronesia, Federated States of",2022,310,604,1547,2461
"Micronesia, Federated States of",2023,244,213,652,1109
"Micronesia, Federated States of",2024,0,0,0,0
"Moldova, Republic of",2005,12834,15161,25288,53283
"Moldova, Republic of",2006,23345,23153,6325,52823
"Moldova, Republic of",2007,29548,25288,8139,62975
"Moldova, Republic of",2008,40492,35717,12481,88690
"Moldova, Republic of",2009,38456,33518,12807,84781
"Moldova, Republic of",2010,38478,32254,25871,96603
"Moldova, Republic of",2011,50327,34213,52778,137318
"Moldova, Republic of",2012,53875,35092,55896,144863
"Moldova, Republic of",2013,57706,42758,44390,144854
"Moldova, Republic of",2014,52674,39626,24661,116961
"Moldova, Republic of",2015,39641,31612,16299,87552
"Moldova, Republic of",2016,50302,42939,18725,111966
"Moldova, Republic of",2017,68358,50155,24746,143259
"Moldova, Republic of",2018,76617,53127,29445,159189
"Moldova, Republic of",2019,76453,55074,30776,162303
"Moldova, Republic of",2020,74735,50735,42112,167582
"Moldova, Republic of",2021,111280,71609,55957,238846
"Moldova, Republic of",2022,116156,73979,55593,245728
"Moldova, Republic of",2023,112558,81274,48862,242694
"Moldova, Republic of",2024,122009,86480,56081,264570
Mongolia,2005,9633,2633,6309,18575
Mongolia,2006,9763,2421,6039,18223
Mongolia,2007,3774,3213,7621,14608
Mongolia,2008,0,0,0,0
Mongolia,2009,0,0,0,0
Mongolia,2010,3873,6872,12749,23494
Mongolia,2011,6352,11030,15038,32420
Mongolia,2012,8105,14025,15359,37489
Mongolia,2013,10270,14598,17580,42448
Mongolia,2014,10262,18454,19952,48668
Mongolia,2015,9106,15516,15307,39929
Mongolia,2016,10342,16330,16244,42916
Mongolia,2017,13070,17317,17391,47778
Mongolia,2018,16096,21521,18171,55788
Mongolia,2019,14078,18974,21504,54556
Mongolia,2020,13182,19266,28351,60799
Mongolia,2021,16103,23297,28412,67812
Mongolia,2022,31125,31687,33865,96677
Mongolia,2023,28838,35280,30662,94780
Mongolia,2024,28195,35015,32051,95261
Montenegro,2005,0,0,0,0
Montenegro,2006,4979,15626,5236,25841
Montenegro,2007,10385,33231,8329,51945
Montenegro,2008,23814,56488,10240,90542
Montenegro,2009,17195,39366,6808,63369
Montenegro,2010,17331,35320,7093,59744
Montenegro,2011,20558,40396,7167,68121
Montenegro,2012,20754,38008,7320,66082
Montenegro,2013,23339,42175,7667,73181
Montenegro,2014,24890,44205,10013,79108
Montenegro,2015,22731,37947,7566,68244
Montenegro,2016,26054,46324,8947,81325
Montenegro,2017,25846,42262,9105,77213
Montenegro,2018,29890,42901,9864,82655
Montenegro,2019,31048,47647,11099,89794
Montenegro,2020,24233,36805,14963,76001
Montenegro,2021,29107,47160,12498,88765
Montenegro,2022,40676,64543,13793,119012
Montenegro,2023,46740,79341,17757,143838
Montenegro,2024,0,0,0,0
Montserrat,2005,43,108,80,231
Montserrat,2006,35,143,97,275
Montserrat,2007,17,97,72,186
Montserrat,2008,35,130,115,280
Montserrat,2009,34,135,153,322
Montserrat,2010,0,0,0,0
Montserrat,2011,0,0,0,0
Montserrat,2012,71,181,170,422
Montserrat,2013,52,180,185,417
Montserrat,2014,53,173,143,369
Montserrat,2015,70,175,130,375
Montserrat,2016,92,216,153,461
Montserrat,2017,61,164,118,343
Montserrat,2018,70,312,284,666
Montserrat,2019,80,271,171,522
Montserrat,2020,75,284,280,639
Montserrat,2021,188,445,247,880
Montserrat,2022,135,560,161,856
Montserrat,2023,149,298,255,702
Montserrat,2024,0,0,0,0
Morocco,2005,153407,112411,26674,292492
Morocco,2006,143744,114841,25430,284015
Morocco,2007,142317,155301,34924,332542
Morocco,2008,119332,205239,46592,371163
Morocco,2009,82150,187304,63210,332664
Morocco,2010,77085,195183,63112,335380
Morocco,2011,102468,239404,62363,404235
Morocco,2012,111428,240236,66340,418004
Morocco,2013,115176,195914,70258,381348
Morocco,2014,138133,231111,76883,446127
Morocco,2015,130734,193729,76023,400486
Morocco,2016,162491,221937,80167,464595
Morocco,2017,197790,247680,102588,548058
Morocco,2018,213977,258249,114764,586990
Morocco,2019,234011,266484,115245,615740
Morocco,2020,213651,249628,127811,591090
Morocco,2021,286172,260213,182492,728877
Morocco,2022,267051,251152,143222,661425
Morocco,2023,259620,262263,179758,701641
Morocco,2024,0,0,0,0
Mozambique,2005,4416,8073,20765,33254
Mozambique,2006,5534,6152,22240,33926
Mozambique,2007,4783,6974,22727,34484
Mozambique,2008,6497,8035,27001,41533
Mozambique,2009,7186,9295,36921,53402
Mozambique,2010,6029,8118,27507,41654
Mozambique,2011,9164,14723,41482,65369
Mozambique,2012,12731,15504,51470,79705
Mozambique,2013,18585,20380,84578,123543
Mozambique,2014,26693,21815,93128,141636
Mozambique,2015,21198,18285,80397,119880
Mozambique,2016,15933,11087,69432,96452
Mozambique,2017,14396,12875,78859,106130
Mozambique,2018,18495,16184,75662,110341
Mozambique,2019,22777,19740,96391,138908
Mozambique,2020,15387,16872,95821,128080
Mozambique,2021,20601,21291,89064,130956
Mozambique,2022,18851,20175,123365,162391
Mozambique,2023,36618,23915,112343,172876
Mozambique,2024,34940,21006,85065,141011
Myanmar,2005,0,0,0,0
Myanmar,2006,0,0,0,0
Myanmar,2007,0,0,0,0
Myanmar,2008,0,0,0,0
Myanmar,2009,0,0,0,0
Myanmar,2010,293,3239,9201,12733
Myanmar,2011,1175,7282,3788,12245
Myanmar,2012,2159,9347,6990,18496
Myanmar,2013,6606,30643,9670,46919
Myanmar,2014,5629,32510,13353,51492
Myanmar,2015,5995,43500,13797,63292
Myanmar,2016,64500,25298,32643,122441
Myanmar,2017,41956,29813,36791,108560
Myanmar,2018,54764,33615,34773,123152
Myanmar,2019,26908,32073,52786,111767
Myanmar,2020,25174,31082,52081,108337
Myanmar,2021,19488,15848,52210,87546
Myanmar,2022,22684,23476,53999,100159
Myanmar,2023,14442,16822,45505,76769
Myanmar,2024,4322,4539,29027,37888
Namibia,2005,43869,38640,18253,100762
Namibia,2006,45199,36637,24914,106750
Namibia,2007,70992,52945,28606,152543
Namibia,2008,58647,49571,35620,143838
Namibia,2009,88955,90152,60622,239729
Namibia,2010,83485,85076,44582,213143
Namibia,2011,88041,91445,54643,234129
Namibia,2012,83180,80393,40746,204319
Namibia,2013,89224,80619,41314,211157
Namibia,2014,105857,76617,48236,230710
Namibia,2015,104377,74397,43265,222039
Namibia,2016,85192,66221,35011,186424
Namibia,2017,98824,67155,37391,203370
Namibia,2018,88192,58443,35014,181649
Namibia,2019,79005,53385,34861,167251
Namibia,2020,54738,45247,37019,137004
Namibia,2021,76977,61491,46981,185449
Namibia,2022,76579,61173,43398,181150
Namibia,2023,72618,54694,38492,165804
Namibia,2024,81149,70903,46115,198167
Nauru,2005,184,67,140,391
Nauru,2006,158,53,103,314
Nauru,2007,102,35,110,247
Nauru,2008,129,82,21,232
Nauru,2009,107,22,27,156
Nauru,2010,24,26,10,60
Nauru,2011,208,62,56,326
Nauru,2012,185,36,36,257
Nauru,2013,652,574,989,2215
Nauru,2014,307,302,397,1006
Nauru,2015,113,349,42,504
Nauru,2016,236,261,303,800
Nauru,2017,165,226,155,546
Nauru,2018,289,237,389,915
Nauru,2019,229,154,99,482
Nauru,2020,82,311,740,1133
Nauru,2021,604,600,224,1428
Nauru,2022,437,456,416,1309
Nauru,2023,210,411,707,1328
Nauru,2024,0,0,0,0
Nepal,2005,0,0,0,0
Nepal,2006,0,0,0,0
Nepal,2007,0,0,0,0
Nepal,2008,0,0,0,0
Nepal,2009,7604,54675,8244,70523
Nepal,2010,10063,57526,10456,78045
Nepal,2011,20501,86011,15076,121588
Nepal,2012,18446,73307,13545,105298
Nepal,2013,22244,68073,14705,105022
Nepal,2014,24557,80691,13436,118684
Nepal,2015,24651,76172,45169,145992
Nepal,2016,30941,91234,17273,139448
Nepal,2017,33895,92219,17040,143154
Nepal,2018,70489,174208,22933,267630
Nepal,2019,80948,206783,18886,306617
Nepal,2020,46554,127062,32615,206231
Nepal,2021,92585,203137,50801,346523
Nepal,2022,73991,136489,20801,231281
Nepal,2023,150321,163323,29101,342745
Nepal,2024,0,0,0,0
Netherlands,2005,2703477,3190796,738074,6632347
Netherlands,2006,3073520,3635719,789125,7498364
Netherlands,2007,3432869,4035563,911157,8379589
Netherlands,2008,3932225,4494628,1056399,9483252
Netherlands,2009,3879869,4131308,973407,8984584
Netherlands,2010,4281031,4250448,1093694,9625173
Netherlands,2011,5289345,5467749,1440324,12197418
Netherlands,2012,4730144,4881665,1212262,10824071
Netherlands,2013,5107820,5071013,1332846,11511679
Netherlands,2014,5664811,5626702,1498196,12789709
Netherlands,2015,5007225,5301939,1393492,11702656
Netherlands,2016,5225980,5334756,1464486,12025222
Netherlands,2017,6033447,5968192,1637036,13638675
Netherlands,2018,6910794,6899016,1828345,15638155
Netherlands,2019,7079759,7458826,1871110,16409695
Netherlands,2020,6508463,6847798,2973781,16330042
Netherlands,2021,8124429,8247511,2705231,19077171
Netherlands,2022,8925638,9013025,2168795,20107458
Netherlands,2023,8035195,8219372,1843381,18097948
Netherlands,2024,8658956,8183426,2028190,18870572
Netherlands Antilles,2005,5347,21106,4721,31174
Netherlands Antilles,2006,6103,23402,4533,34038
Netherlands Antilles,2007,7377,29526,5790,42693
Netherlands Antilles,2008,10258,33550,6778,50586
Netherlands Antilles,2009,50386,51469,10506,112361
Netherlands Antilles,2010,86808,55976,8220,151004
Netherlands Antilles,2011,0,0,0,0
Netherlands Antilles,2012,0,0,0,0
Netherlands Antilles,2013,0,0,0,0
Netherlands Antilles,2014,0,0,0,0
Netherlands Antilles,2015,0,0,0,0
Netherlands Antilles,2016,0,0,0,0
Netherlands Antilles,2017,0,0,0,0
Netherlands Antilles,2018,0,0,0,0
Netherlands Antilles,2019,0,0,0,0
Netherlands Antilles,2020,0,0,0,0
Netherlands Antilles,2021,0,0,0,0
Netherlands Antilles,2022,0,0,0,0
Netherlands Antilles,2023,0,0,0,0
Netherlands Antilles,2024,0,0,0,0
Neutral Zone,2005,0,0,0,0
Neutral Zone,2006,0,0,0,0
Neutral Zone,2007,8,0,0,8
Neutral Zone,2008,0,0,0,0
Neutral Zone,2009,0,0,0,0
Neutral Zone,2010,0,0,0,0
Neutral Zone,2011,0,0,0,0
Neutral Zone,2012,0,0,0,0
Neutral Zone,2013,0,0,0,0
Neutral Zone,2014,0,0,0,0
Neutral Zone,2015,0,0,0,0
Neutral Zone,2016,0,0,0,0
Neutral Zone,2017,0,0,0,0
Neutral Zone,2018,0,0,0,0
Neutral Zone,2019,0,0,0,0
Neutral Zone,2020,0,0,0,0
Neutral Zone,2021,0,0,0,0
Neutral Zone,2022,0,0,0,0
Neutral Zone,2023,0,0,0,0
Neutral Zone,2024,0,0,0,0
New Caledonia,2005,14897,18819,7941,41657
New Caledonia,2006,14769,20654,9661,45084
New Caledonia,2007,14869,20345,9078,44292
New Caledonia,2008,21542,27597,11906,61045
New Caledonia,2009,19392,25742,10788,55922
New Caledonia,2010,21779,24770,12704,59253
New Caledonia,2011,23712,28336,14317,66365
New Caledonia,2012,21498,28712,13405,63615
New Caledonia,2013,22907,27825,12485,63217
New Caledonia,2014,23680,28935,13253,65868
New Caledonia,2015,19897,26486,11118,57501
New Caledonia,2016,14592,14997,6629,36218
New Caledonia,2017,13441,11372,6427,31240
New Caledonia,2018,12548,14222,6319,33089
New Caledonia,2019,13198,13375,6677,33250
New Caledonia,2020,13658,14608,13248,41514
New Caledonia,2021,17001,16045,13939,46985
New Caledonia,2022,17599,15682,10538,43819
New Caledonia,2023,15191,15481,10187,40859
New Caledonia,2024,0,0,0,0
New Zealand,2005,318758,328126,154777,801661
New Zealand,2006,345589,334313,162013,841915
New Zealand,2007,408160,399224,173933,981317
New Zealand,2008,425931,409451,174762,1010144
New Zealand,2009,399129,359757,155055,913941
New Zealand,2010,471512,423612,178052,1073176
New Zealand,2011,537424,492936,206616,1236976
New Zealand,2012,538140,524382,217003,1279525
New Zealand,2013,558474,535997,233480,1327951
New Zealand,2014,569020,561347,248094,1378461
New Zealand,2015,561650,539663,228279,1329592
New Zealand,2016,559458,531733,243171,1334362
New Zealand,2017,551799,541666,246940,1340405
New Zealand,2018,583900,596971,270704,1451575
New Zealand,2019,577076,583790,270728,1431594
New Zealand,2020,497040,487457,396038,1380535
New Zealand,2021,680402,628706,393012,1702120
New Zealand,2022,700739,662474,420939,1784152
New Zealand,2023,636174,600801,275015,1511990
New Zealand,2024,638665,585063,283152,1506880
Nicaragua,2005,9051,17482,15229,41762
Nicaragua,2006,11255,18047,14215,43517
Nicaragua,2007,11883,23806,20702,56391
Nicaragua,2008,11785,22337,16247,50369
Nicaragua,2009,12340,18171,20825,51336
Nicaragua,2010,14852,19550,31382,65784
Nicaragua,2011,18100,19358,35491,72949
Nicaragua,2012,24693,22125,43067,89885
Nicaragua,2013,24340,22501,44210,91051
Nicaragua,2014,23526,27385,47743,98654
Nicaragua,2015,25135,24352,53817,103304
Nicaragua,2016,300763,50778,71165,422706
Nicaragua,2017,346404,55377,81949,483730
Nicaragua,2018,397804,58391,77756,533951
Nicaragua,2019,439156,63231,81479,583866
Nicaragua,2020,288094,79874,114729,482697
Nicaragua,2021,504634,189433,120130,814197
Nicaragua,2022,761686,302112,138775,1202573
Nicaragua,2023,689663,126484,116737,932884
Nicaragua,2024,0,0,0,0
Niger,2005,383,1979,38759,41121
Niger,2006,524,2112,40965,43601
Niger,2007,955,2112,44938,48005
Niger,2008,526,3724,58054,62304
Niger,2009,7641,2393,71115,81149
Niger,2010,1119,2977,52250,56346
Niger,2011,937,3797,52803,57537
Niger,2012,2036,6760,47007,55803
Niger,2013,2511,9333,46199,58043
Niger,2014,1668,10705,39139,51512
Niger,2015,1263,8564,47543,57370
Niger,2016,1048,4460,19457,24965
Niger,2017,1295,5054,31178,37527
Niger,2018,1773,1720,44813,48306
Niger,2019,2791,4615,43910,51316
Niger,2020,1509,4052,51577,57138
Niger,2021,1602,5894,46403,53899
Niger,2022,2092,6752,118814,127658
Niger,2023,1002,5347,23701,30050
Niger,2024,0,0,0,0
Nigeria,2005,0,0,0,0
Nigeria,2006,1028,1328,4629,6985
Nigeria,2007,905,1371,28589,30865
Nigeria,2008,2203,1541,27728,31472
Nigeria,2009,5096,15387,204893,225376
Nigeria,2010,10416,9862,47792,68070
Nigeria,2011,15945,86340,101219,203504
Nigeria,2012,11218,34324,43787,89329
Nigeria,2013,10626,18290,53832,82748
Nigeria,2014,18560,17003,69031,104594
Nigeria,2015,12705,13538,44427,70670
Nigeria,2016,12180,9704,17222,39106
Nigeria,2017,9131,6350,20656,36137
Nigeria,2018,18006,8140,40815,66961
Nigeria,2019,23096,14947,93070,131113
Nigeria,2020,23633,22016,141838,187487
Nigeria,2021,103891,30542,72916,207349
Nigeria,2022,145142,17864,111675,274681
Nigeria,2023,108531,13577,68477,190585
Nigeria,2024,0,0,0,0
Niue,2005,287,44,8,339
Niue,2006,30,166,5,201
Niue,2007,24,27,9,60
Niue,2008,36,18,25,79
Niue,2009,797,167,12,976
Niue,2010,1629,44,509,2182
Niue,2011,22,27,139,188
Niue,2012,139,28,20,187
Niue,2013,196,66,41,303
Niue,2014,60,55,31,146
Niue,2015,39,34,33,106
Niue,2016,27,22,67,116
Niue,2017,16,18,29,63
Niue,2018,46,54,34,134
Niue,2019,44,37,63,144
Niue,2020,12,13,42,67
Niue,2021,8,18,206,232
Niue,2022,12,37,77,126
Niue,2023,24,23,30,77
Niue,2024,0,0,0,0
Norfolk Island,2005,516,135,636,1287
Norfolk Island,2006,116,451,485,1052
Norfolk Island,2007,418,85,582,1085
Norfolk Island,2008,283,106,165,554
Norfolk Island,2009,172,39,106,317
Norfolk Island,2010,112,45,57,214
Norfolk Island,2011,77,95,50,222
Norfolk Island,2012,109,36,77,222
Norfolk Island,2013,84,743,59,886
Norfolk Island,2014,75,1078,67,1220
Norfolk Island,2015,93,589,49,731
Norfolk Island,2016,1872,1731,231,3834
Norfolk Island,2017,82,3642,55,3779
Norfolk Island,2018,62,2932,102,3096
Norfolk Island,2019,38,3865,37,3940
Norfolk Island,2020,50,3091,107,3248
Norfolk Island,2021,256,3764,65,4085
Norfolk Island,2022,327,5768,139,6234
Norfolk Island,2023,88,904,26,1018
Norfolk Island,2024,0,0,0,0
Northern Mariana Islands,2005,15120,1796,207,17123
Northern Mariana Islands,2006,15578,973,246,16797
Northern Mariana Islands,2007,4096,778,210,5084
Northern Mariana Islands,2008,2248,529,209,2986
Northern Mariana Islands,2009,390,807,115,1312
Northern Mariana Islands,2010,1390,1623,171,3184
Northern Mariana Islands,2011,2201,2470,90,4761
Northern Mariana Islands,2012,2553,2248,108,4909
Northern Mariana Islands,2013,2113,4103,127,6343
Northern Mariana Islands,2014,1467,3102,206,4775
Northern Mariana Islands,2015,520,2951,232,3703
Northern Mariana Islands,2016,841,2487,112,3440
Northern Mariana Islands,2017,1115,2669,333,4117
Northern Mariana Islands,2018,1572,2062,533,4167
Northern Mariana Islands,2019,1820,2272,364,4456
Northern Mariana Islands,2020,459,518,1432,2409
Northern Mariana Islands,2021,110,45,79,234
Northern Mariana Islands,2022,671,1242,202,2115
Northern Mariana Islands,2023,1116,1377,238,2731
Northern Mariana Islands,2024,0,0,0,0
Norway,2005,750260,958269,269858,1978387
Norway,2006,811946,1013123,276304,2101373
Norway,2007,980017,1134569,330170,2444756
Norway,2008,1095066,1251075,345672,2691813
Norway,2009,1007342,1099341,302355,2409038
Norway,2010,1133431,1183374,332605,2649410
Norway,2011,1259144,1423842,405599,3088585
Norway,2012,1123725,1341811,365070,2830606
Norway,2013,1215097,1388556,399463,3003116
Norway,2014,1209854,1313924,406400,2930178
Norway,2015,1065630,1152813,358357,2576800
Norway,2016,1059014,1131286,341778,2532078
Norway,2017,1088482,1198178,377817,2664477
Norway,2018,1161128,1254867,400730,2816725
Norway,2019,1085748,1219184,404915,2709847
Norway,2020,1006368,1176710,527927,2711005
Norway,2021,1285338,1322545,564334,3172217
Norway,2022,1333768,1424283,503229,3261280
Norway,2023,1101982,1226592,413169,2741743
Norway,2024,1145237,1244179,416976,2806392
Oman,2005,18964,39287,17229,75480
Oman,2006,22475,39771,18571,80817
Oman,2007,26131,75614,22834,124579
Oman,2008,39063,108302,30511,177876
Oman,2009,46444,96212,27571,170227
Oman,2010,98596,62232,35127,195955
Oman,2011,125595,73038,40317,238950
Oman,2012,144542,77490,46448,268480
Oman,2013,117137,83941,48662,249740
Oman,2014,125082,91015,48617,264714
Oman,2015,143220,105518,50720,299458
Oman,2016,110363,86122,44051,240536
Oman,2017,153624,117395,48211,319230
Oman,2018,173672,127841,47178,348691
Oman,2019,181412,129871,49381,360664
Oman,2020,136233,105132,100919,342284
Oman,2021,183389,135599,72697,391685
Oman,2022,177812,114030,68763,360605
Oman,2023,173718,132953,71680,378351
Oman,2024,0,0,0,0
Pakistan,2005,10179,8521,71917,90617
Pakistan,2006,14266,10697,85393,110356
Pakistan,2007,25888,24986,94102,144976
Pakistan,2008,25865,19317,120137,165319
Pakistan,2009,17334,17255,126389,160978
Pakistan,2010,27757,28297,182973,239027
Pakistan,2011,29929,27307,200791,258027
Pakistan,2012,23641,26815,197537,247993
Pakistan,2013,25019,22254,198162,245435
Pakistan,2014,33440,33311,230203,296954
Pakistan,2015,44129,41384,280988,366501
Pakistan,2016,53363,30116,314334,397813
Pakistan,2017,60733,30504,312023,403260
Pakistan,2018,58494,53643,342787,454924
Pakistan,2019,49485,45996,265080,360561
Pakistan,2020,38920,38027,255325,332272
Pakistan,2021,69218,42592,438529,550339
Pakistan,2022,49670,36850,447312,533832
Pakistan,2023,37197,24953,411505,473655
Pakistan,2024,50681,31046,496507,578234
Palau,2005,0,0,0,0
Palau,2006,0,0,0,0
Palau,2007,0,0,0,0
Palau,2008,0,0,0,0
Palau,2009,0,0,0,0
Palau,2010,0,0,0,0
Palau,2011,0,0,0,0
Palau,2012,710,1133,424,2267
Palau,2013,0,0,0,0
Palau,2014,858,1196,720,2774
Palau,2015,924,925,778,2627
Palau,2016,936,1116,780,2832
Palau,2017,779,1144,630,2553
Palau,2018,717,1095,628,2440
Palau,2019,127,49,282,458
Palau,2020,484,395,520,1399
Palau,2021,242,213,223,678
Palau,2022,105,81,177,363
Palau,2023,612,241,299,1152
Palau,2024,0,0,0,0
"Palestine, State of",2005,0,0,0,0
"Palestine, State of",2006,0,0,0,0
"Palestine, State of",2007,8214,18006,5665,31885
"Palestine, State of",2008,10943,21971,6598,39512
"Palestine, State of",2009,12163,24845,8378,45386
"Palestine, State of",2010,14315,27105,9847,51267
"Palestine, State of",2011,15469,31747,10117,57333
"Palestine, State of",2012,20102,28105,10629,58836
"Palestine, State of",2013,17901,33034,14114,65049
"Palestine, State of",2014,22180,41260,15100,78540
"Palestine, State of",2015,25191,52120,17936,95247
"Palestine, State of",2016,30438,58595,17302,106335
"Palestine, State of",2017,23282,50923,15288,89493
"Palestine, State of",2018,24726,43294,12820,80840
"Palestine, State of",2019,31488,42326,15256,89070
"Palestine, State of",2020,31337,39623,19134,90094
"Palestine, State of",2021,52231,51367,23324,126922
"Palestine, State of",2022,57100,58474,22242,137816
"Palestine, State of",2023,5876,11404,2485,19765
"Palestine, State of",2024,0,0,0,0
Panama,2005,26790,74657,13655,115102
Panama,2006,426963,1083785,192323,1703071
Panama,2007,507912,1220632,206101,1934645
Panama,2008,614817,1296130,259275,2170222
Panama,2009,444945,935773,149572,1530290
Panama,2010,656043,1420751,189044,2265838
Panama,2011,839572,1744696,257122,2841390
Panama,2012,855957,1800492,263294,2919743
Panama,2013,696515,1349569,162050,2208134
Panama,2014,616556,1330002,170805,2117363
Panama,2015,637161,1325514,162268,2124943
Panama,2016,503551,1050593,116422,1670566
Panama,2017,535357,975859,131949,1643165
Panama,2018,558533,979581,139527,1677641
Panama,2019,552662,1000387,140025,1693074
Panama,2020,340390,514487,176456,1031333
Panama,2021,561511,1010782,200266,1772559
Panama,2022,717168,1153994,229312,2100474
Panama,2023,631908,1082082,151997,1865987
Panama,2024,179747,266518,57188,503453
Papua New Guinea,2005,0,0,0,0
Papua New Guinea,2006,0,0,0,0
Papua New Guinea,2007,0,0,0,0
Papua New Guinea,2008,0,0,0,0
Papua New Guinea,2009,0,0,0,0
Papua New Guinea,2010,0,0,0,0
Papua New Guinea,2011,9880,37125,56052,103057
Papua New Guinea,2012,14996,32781,58125,105902
Papua New Guinea,2013,0,0,0,0
Papua New Guinea,2014,0,0,0,0
Papua New Guinea,2015,0,0,0,0
Papua New Guinea,2016,0,0,0,0
Papua New Guinea,2017,0,0,0,0
Papua New Guinea,2018,0,0,0,0
Papua New Guinea,2019,15678,25482,44672,85832
Papua New Guinea,2020,9830,21468,55366,86664
Papua New Guinea,2021,13508,24283,58173,95964
Papua New Guinea,2022,18043,26449,71439,115931
Papua New Guinea,2023,14970,29892,56133,100995
Papua New Guinea,2024,0,0,0,0
Paraguay,2005,21524,12386,7258,41168
Paraguay,2006,25889,15202,8903,49994
Paraguay,2007,34903,17937,11804,64644
Paraguay,2008,51708,37747,24973,114428
Paraguay,2009,44381,30685,16833,91899
Paraguay,2010,60057,46586,34920,141563
Paraguay,2011,78952,56324,37594,172870
Paraguay,2012,69218,55746,29214,154178
Paraguay,2013,72299,58029,23638,153966
Paraguay,2014,71369,53434,22401,147204
Paraguay,2015,55532,46014,16397,117943
Paraguay,2016,57460,46229,14962,118651
Paraguay,2017,75288,66986,20189,162463
Paraguay,2018,70982,59291,20336,150609
Paraguay,2019,67029,55005,18031,140065
Paraguay,2020,43373,42706,35226,121305
Paraguay,2021,53170,37156,19131,109457
Paraguay,2022,69229,56274,23664,149167
Paraguay,2023,87792,69585,26568,183945
Paraguay,2024,94842,66795,31139,192776
Peru,2005,45611,51152,18059,114822
Peru,2006,50061,66436,21395,137892
Peru,2007,65791,94864,25422,186077
Peru,2008,96727,127811,37715,262253
Peru,2009,101527,128432,38002,267961
Peru,2010,183057,234014,55799,472870
Peru,2011,213164,233118,70856,517138
Peru,2012,367995,519466,93583,981044
Peru,2013,471658,654371,116084,1242113
Peru,2014,322736,363824,111033,797593
Peru,2015,311480,336383,109325,757188
Peru,2016,276946,320793,113289,711028
Peru,2017,300638,348123,116762,765523
Peru,2018,339899,411883,132894,884676
Peru,2019,375959,423479,140187,939625
Peru,2020,293839,315951,576056,1185846
Peru,2021,386306,311718,298325,996349
Peru,2022,518830,414390,246577,1179797
Peru,2023,434777,401855,149607,986239
Peru,2024,438078,430534,181752,1050364
Philippines,2005,31438,43725,18938,94101
Philippines,2006,38240,46623,23735,108598
Philippines,2007,42062,42328,19657,104047
Philippines,2008,33519,52947,21731,108197
Philippines,2009,28821,58927,24751,112499
Philippines,2010,36292,76110,33079,145481
Philippines,2011,56435,127196,51683,235314
Philippines,2012,52779,159195,40235,252209
Philippines,2013,73448,182835,51920,308203
Philippines,2014,117076,192983,69467,379526
Philippines,2015,149786,226580,74644,451010
Philippines,2016,174291,210877,125667,510835
Philippines,2017,192771,218100,130209,541080
Philippines,2018,236482,276448,177494,690424
Philippines,2019,271504,297148,205494,774146
Philippines,2020,169759,245895,214723,630377
Philippines,2021,156772,214544,274677,645993
Philippines,2022,287935,323288,261007,872230
Philippines,2023,346311,343573,240488,930372
Philippines,2024,371993,359559,233755,965307
Pitcairn,2005,2,0,9,11
Pitcairn,2006,8,24,4,36
Pitcairn,2007,5,3,4,12
Pitcairn,2008,4,277,4,285
Pitcairn,2009,5,0,0,5
Pitcairn,2010,36,2,0,38
Pitcairn,2011,7,0,0,7
Pitcairn,2012,2,6,0,8
Pitcairn,2013,5,3,16,24
Pitcairn,2014,4,0,0,4
Pitcairn,2015,29,0,0,29
Pitcairn,2016,5,521,0,526
Pitcairn,2017,8,922,2,932
Pitcairn,2018,6,820,0,826
Pitcairn,2019,15,139,2,156
Pitcairn,2020,2,0,0,2
Pitcairn,2021,0,0,0,0
Pitcairn,2022,5,0,3266,3271
Pitcairn,2023,8,0,1,9
Pitcairn,2024,0,0,0,0
Poland,2005,533211,601490,316147,1450848
Poland,2006,658608,769016,371369,1798993
Poland,2007,919137,1025621,513274,2458032
Poland,2008,1554329,1674991,683819,3913139
Poland,2009,1564392,1672608,583118,3820118
Poland,2010,1753726,1742482,594560,4090768
Poland,2011,2027053,2156584,665566,4849203
Poland,2012,1706382,1862836,610208,4179426
Poland,2013,1866833,2021621,758694,4647148
Poland,2014,2361351,2579558,900119,5841028
Poland,2015,2434422,2660290,821590,5916302
Poland,2016,2718071,2880649,909309,6508029
Poland,2017,3048896,3202355,937466,7188717
Poland,2018,3875571,4255836,1083445,9214852
Poland,2019,4047089,4234356,1130703,9412148
Poland,2020,4838205,5310861,1575207,11724273
Poland,2021,6196198,6328615,1486931,14011744
Poland,2022,7082219,5434159,1483638,14000016
Poland,2023,6718668,5328120,1242384,13289172
Poland,2024,7853401,8295201,1407553,17556155
Portugal,2005,815578,838688,129346,1783612
Portugal,2006,923814,963313,148615,2035742
Portugal,2007,1119792,1106536,196478,2422806
Portugal,2008,1231751,1197733,213217,2642701
Portugal,2009,1142967,1176320,194064,2513351
Portugal,2010,1203064,1161917,211535,2576516
Portugal,2011,1250353,1192185,216138,2658676
Portugal,2012,990616,1012364,163260,2166240
Portugal,2013,1050824,1098503,176588,2325915
Portugal,2014,1167611,1234702,190585,2592898
Portugal,2015,1076191,1079030,166883,2322104
Portugal,2016,1113289,1104953,171008,2389250
Portugal,2017,1169827,1202979,191211,2564017
Portugal,2018,1393745,1427898,229726,3051369
Portugal,2019,1299124,1330633,219924,2849681
Portugal,2020,1026406,1013778,525811,2565995
Portugal,2021,1246904,1177443,308072,2732419
Portugal,2022,1516468,1432850,327498,3276816
Portugal,2023,1674579,1519754,328085,3522418
Portugal,2024,1719710,1579840,320606,3620156
Qatar,2005,36300,95227,27855,159382
Qatar,2006,36792,164268,43169,244229
Qatar,2007,68066,184143,37214,289423
Qatar,2008,78809,207192,41494,327495
Qatar,2009,88239,194257,62681,345177
Qatar,2010,97712,210176,73473,381361
Qatar,2011,124048,243267,61466,428781
Qatar,2012,131814,266280,82075,480169
Qatar,2013,171788,280112,74949,526849
Qatar,2014,218212,336594,88786,643592
Qatar,2015,267615,386795,99773,754183
Qatar,2016,0,0,0,0
Qatar,2017,289771,413473,93806,797050
Qatar,2018,291895,417711,82717,792323
Qatar,2019,268336,406767,87997,763100
Qatar,2020,224385,435323,201196,860904
Qatar,2021,281710,457145,88853,827708
Qatar,2022,382812,476771,146788,1006371
Qatar,2023,340415,402582,69407,812404
Qatar,2024,0,0,0,0
Romania,2005,289951,360776,106788,757515
Romania,2006,311585,373434,138909,823928
Romania,2007,415197,496576,212801,1124574
Romania,2008,520055,648507,241686,1410248
Romania,2009,425081,459969,175167,1060217
Romania,2010,405926,440971,183635,1030532
Romania,2011,472664,558104,211849,1242617
Romania,2012,476178,542663,207025,1225866
Romania,2013,500589,568168,218667,1287424
Romania,2014,559546,632838,251138,1443522
Romania,2015,517737,596414,231012,1345163
Romania,2016,654641,748520,275401,1678562
Romania,2017,772441,872159,309849,1954449
Romania,2018,894316,1016320,335033,2245669
Romania,2019,958962,1041925,337352,2338239
Romania,2020,940551,994542,735471,2670564
Romania,2021,1228123,1078326,474707,2781156
Romania,2022,1413799,1166678,460783,3041260
Romania,2023,1411770,1256844,474514,3143128
Romania,2024,1612321,1353157,502601,3468079
Russian Federation,2005,353925,448454,251079,1053458
Russian Federation,2006,647224,851380,387523,1886127
Russian Federation,2007,1184733,1656549,536301,3377583
Russian Federation,2008,1834196,2391166,698644,4924006
Russian Federation,2009,1629279,2045033,542990,4217302
Russian Federation,2010,2580650,2971425,719781,6271856
Russian Federation,2011,3271393,3470072,902619,7644084
Russian Federation,2012,4099764,4097249,1270677,9467690
Russian Federation,2013,4066353,4124911,1092722,9283986
Russian Federation,2014,3724664,4023985,922643,8671292
Russian Federation,2015,2363359,2592471,655189,5611019
Russian Federation,2016,2560676,2700409,643439,5904524
Russian Federation,2017,3181207,3394030,731414,7306651
Russian Federation,2018,3354841,3706899,809785,7871525
Russian Federation,2019,3552005,3790354,824905,8167264
Russian Federation,2020,3047305,3866214,1402213,8315732
Russian Federation,2021,4018820,3933832,1002403,8955055
Russian Federation,2022,3212887,2555828,818127,6586842
Russian Federation,2023,4157652,3676725,930180,8764557
Russian Federation,2024,0,0,0,0
Rwanda,2005,1953,1149,10572,13674
Rwanda,2006,1740,1556,120643,123939
Rwanda,2007,3142,3572,21059,27773
Rwanda,2008,4578,3759,26749,35086
Rwanda,2009,3550,2784,25831,32165
Rwanda,2010,4179,3835,53442,61456
Rwanda,2011,5663,3698,25796,35157
Rwanda,2012,4895,5226,40773,50894
Rwanda,2013,2983,7152,42658,52793
Rwanda,2014,3995,11617,30097,45709
Rwanda,2015,5330,22182,63266,90778
Rwanda,2016,12041,15045,66151,93237
Rwanda,2017,8400,11742,37688,57830
Rwanda,2018,11867,12668,34643,59178
Rwanda,2019,13188,20414,50362,83964
Rwanda,2020,13195,20836,55910,89941
Rwanda,2021,17400,23274,55193,95867
Rwanda,2022,13687,27957,48567,90211
Rwanda,2023,11642,9198,22056,42896
Rwanda,2024,0,0,0,0
Saint Helena,2005,207,75,36,318
Saint Helena,2006,191,141,68,400
Saint Helena,2007,191,212,181,584
Saint Helena,2008,67,75,34,176
Saint Helena,2009,105,88,46,239
Saint Helena,2010,72,125,45,242
Saint Helena,2011,34,83,103,220
Saint Helena,2012,86,162,95,343
Saint Helena,2013,98,177,85,360
Saint Helena,2014,108,169,148,425
Saint Helena,2015,209,158,162,529
Saint Helena,2016,159,158,103,420
Saint Helena,2017,154,110,106,370
Saint Helena,2018,272,117,88,477
Saint Helena,2019,261,152,82,495
Saint Helena,2020,190,114,119,423
Saint Helena,2021,371,157,150,678
Saint Helena,2022,443,88,167,698
Saint Helena,2023,323,192,80,595
Saint Helena,2024,0,0,0,0
Saint Kitts and Nevis,2005,967,1969,626,3562
Saint Kitts and Nevis,2006,1209,2168,1596,4973
Saint Kitts and Nevis,2007,1588,2522,1288,5398
Saint Kitts and Nevis,2008,1812,3225,1399,6436
Saint Kitts and Nevis,2009,1651,4741,1474,7866
Saint Kitts and Nevis,2010,1366,4630,1303,7299
Saint Kitts and Nevis,2011,1272,3962,1315,6549
Saint Kitts and Nevis,2012,1253,3428,1220,5901
Saint Kitts and Nevis,2013,1232,3961,1168,6361
Saint Kitts and Nevis,2014,1704,4574,1300,7578
Saint Kitts and Nevis,2015,1456,5821,1418,8695
Saint Kitts and Nevis,2016,2024,6220,2223,10467
Saint Kitts and Nevis,2017,1579,5878,1925,9382
Saint Kitts and Nevis,2018,1570,1217,1016,3803
Saint Kitts and Nevis,2019,1600,1383,1551,4534
Saint Kitts and Nevis,2020,440,787,1103,2330
Saint Kitts and Nevis,2021,291,739,1237,2267
Saint Kitts and Nevis,2022,1236,1369,1108,3713
Saint Kitts and Nevis,2023,1976,1376,1388,4740
Saint Kitts and Nevis,2024,0,0,0,0
Saint Lucia,2005,2466,6159,2435,11060
Saint Lucia,2006,3125,6129,2860,12114
Saint Lucia,2007,2414,5771,1897,10082
Saint Lucia,2008,2908,6865,1825,11598
Saint Lucia,2009,0,0,0,0
Saint Lucia,2010,0,0,0,0
Saint Lucia,2011,0,0,0,0
Saint Lucia,2012,2643,5276,3342,11261
Saint Lucia,2013,1630,5242,4399,11271
Saint Lucia,2014,1766,5993,3998,11757
Saint Lucia,2015,1510,5377,3509,10396
Saint Lucia,2016,1628,5114,4684,11426
Saint Lucia,2017,1528,5858,4208,11594
Saint Lucia,2018,2215,6560,4484,13259
Saint Lucia,2019,1483,5287,4333,11103
Saint Lucia,2020,1311,3425,4073,8809
Saint Lucia,2021,905,2032,1933,4870
Saint Lucia,2022,1978,3803,3103,8884
Saint Lucia,2023,2667,3605,3142,9414
Saint Lucia,2024,0,0,0,0
Saint Pierre and Miquelon,2005,1336,938,331,2605
Saint Pierre and Miquelon,2006,877,1215,369,2461
Saint Pierre and Miquelon,2007,811,896,346,2053
Saint Pierre and Miquelon,2008,231,949,343,1523
Saint Pierre and Miquelon,2009,235,622,300,1157
Saint Pierre and Miquelon,2010,261,778,292,1331
Saint Pierre and Miquelon,2011,263,827,284,1374
Saint Pierre and Miquelon,2012,296,896,324,1516
Saint Pierre and Miquelon,2013,278,714,559,1551
Saint Pierre and Miquelon,2014,391,639,639,1669
Saint Pierre and Miquelon,2015,478,445,966,1889
Saint Pierre and Miquelon,2016,663,401,704,1768
Saint Pierre and Miquelon,2017,419,386,625,1430
Saint Pierre and Miquelon,2018,563,323,618,1504
Saint Pierre and Miquelon,2019,587,261,461,1309
Saint Pierre and Miquelon,2020,617,364,1072,2053
Saint Pierre and Miquelon,2021,941,321,663,1925
Saint Pierre and Miquelon,2022,669,459,345,1473
Saint Pierre and Miquelon,2023,596,532,267,1395
Saint Pierre and Miquelon,2024,0,0,0,0
Saint Vincent and the Grenadines,2005,1278,2492,1799,5569
Saint Vincent and the Grenadines,2006,1070,2546,1448,5064
Saint Vincent and the Grenadines,2007,1211,2954,1751,5916
Saint Vincent and the Grenadines,2008,1134,3624,2296,7054
Saint Vincent and the Grenadines,2009,1236,3405,1591,6232
Saint Vincent and the Grenadines,2010,1744,3623,1991,7358
Saint Vincent and the Grenadines,2011,1272,3416,1682,6370
Saint Vincent and the Grenadines,2012,1114,3754,1754,6622
Saint Vincent and the Grenadines,2013,990,4106,2353,7449
Saint Vincent and the Grenadines,2014,1254,4111,1785,7150
Saint Vincent and the Grenadines,2015,1479,5008,1894,8381
Saint Vincent and the Grenadines,2016,926,4609,1694,7229
Saint Vincent and the Grenadines,2017,1208,4140,2126,7474
Saint Vincent and the Grenadines,2018,1009,4762,3221,8992
Saint Vincent and the Grenadines,2019,1093,4538,1998,7629
Saint Vincent and the Grenadines,2020,1003,4023,2376,7402
Saint Vincent and the Grenadines,2021,1380,5428,3935,10743
Saint Vincent and the Grenadines,2022,1037,4854,3387,9278
Saint Vincent and the Grenadines,2023,1435,5662,2777,9874
Saint Vincent and the Grenadines,2024,0,0,0,0
Samoa,2005,1021,1686,722,3429
Samoa,2006,1045,1932,834,3811
Samoa,2007,1027,1533,708,3268
Samoa,2008,803,1850,767,3420
Samoa,2009,522,1313,926,2761
Samoa,2010,624,1456,1000,3080
Samoa,2011,599,1867,1081,3547
Samoa,2012,572,1580,937,3089
Samoa,2013,934,1843,1235,4012
Samoa,2014,995,2758,1924,5677
Samoa,2015,1231,2387,1420,5038
Samoa,2016,902,2778,1425,5105
Samoa,2017,1119,3075,1354,5548
Samoa,2018,1395,3342,1551,6288
Samoa,2019,1647,4564,1996,8207
Samoa,2020,1128,1994,1028,4150
Samoa,2021,1597,4298,1175,7070
Samoa,2022,1826,4971,2386,9183
Samoa,2023,2392,5576,2128,10096
Samoa,2024,0,0,0,0
Sao Tome and Principe,2005,32,68,429,529
Sao Tome and Principe,2006,308,377,557,1242
Sao Tome and Principe,2007,141,188,470,799
Sao Tome and Principe,2008,171,353,1539,2063
Sao Tome and Principe,2009,195,245,671,1111
Sao Tome and Principe,2010,757,556,927,2240
Sao Tome and Principe,2011,1371,268,1119,2758
Sao Tome and Principe,2012,513,276,1303,2092
Sao Tome and Principe,2013,414,326,1461,2201
Sao Tome and Principe,2014,1642,639,1835,4116
Sao Tome and Principe,2015,466,396,1176,2038
Sao Tome and Principe,2016,956,372,1602,2930
Sao Tome and Principe,2017,310,271,1974,2555
Sao Tome and Principe,2018,671,402,2034,3107
Sao Tome and Principe,2019,584,295,2499,3378
Sao Tome and Principe,2020,550,171,2200,2921
Sao Tome and Principe,2021,710,322,3563,4595
Sao Tome and Principe,2022,474,234,3404,4112
Sao Tome and Principe,2023,360,363,2019,2742
Sao Tome and Principe,2024,0,0,0,0
Saudi Arabia,2005,184936,1052165,183049,1420150
Saudi Arabia,2006,251019,1172107,181115,1604241
Saudi Arabia,2007,346374,1353119,234783,1934276
Saudi Arabia,2008,412230,1633368,266440,2312038
Saudi Arabia,2009,441188,1466781,203325,2111294
Saudi Arabia,2010,534642,1482875,250256,2267773
Saudi Arabia,2011,860091,1775261,277781,2913133
Saudi Arabia,2012,814340,1958213,351224,3123777
Saudi Arabia,2013,801458,2191579,363352,3356389
Saudi Arabia,2014,1071323,2290944,462974,3825241
Saudi Arabia,2015,1162204,2601242,447638,4211084
Saudi Arabia,2016,1332008,2102210,397337,3831555
Saudi Arabia,2017,1447025,1751963,365804,3564792
Saudi Arabia,2018,1431602,1752959,360046,3544607
Saudi Arabia,2019,1640327,2219834,450660,4310821
Saudi Arabia,2020,1446861,1572211,727960,3747032
Saudi Arabia,2021,1870878,2071561,392026,4334465
Saudi Arabia,2022,1988635,2351297,369598,4709530
Saudi Arabia,2023,1931074,2301198,385964,4618236
Saudi Arabia,2024,1810851,2285013,366281,4462145
Senegal,2005,4420,8481,28690,41591
Senegal,2006,5608,7663,22413,35684
Senegal,2007,10915,11285,36884,59084
Senegal,2008,9881,11506,42416,63803
Senegal,2009,9510,10714,56028,76252
Senegal,2010,8989,10453,47285,66727
Senegal,2011,8726,12300,41710,62736
Senegal,2012,7432,10997,44146,62575
Senegal,2013,7247,12008,62040,81295
Senegal,2014,7427,14646,53617,75690
Senegal,2015,7153,11016,54236,72405
Senegal,2016,6525,11153,38071,55749
Senegal,2017,7517,12629,45929,66075
Senegal,2018,8744,14576,53128,76448
Senegal,2019,10411,19608,54496,84515
Senegal,2020,10878,22329,56278,89485
Senegal,2021,8518,13581,62600,84699
Senegal,2022,12587,18046,56691,87324
Senegal,2023,9751,25740,54917,90408
Senegal,2024,0,0,0,0
Serbia,2005,0,0,0,0
Serbia,2006,88807,119557,18374,226738
Serbia,2007,157022,184686,32018,373726
Serbia,2008,213986,250455,44862,509303
Serbia,2009,161900,150713,28376,340989
Serbia,2010,136493,135284,25514,297291
Serbia,2011,154596,148517,31113,334226
Serbia,2012,151051,139309,27600,317960
Serbia,2013,173239,141008,29566,343813
Serbia,2014,186506,158770,33235,378511
Serbia,2015,142064,137221,30657,309942
Serbia,2016,162704,151714,34419,348837
Serbia,2017,169071,168137,46781,383989
Serbia,2018,205629,195474,53465,454568
Serbia,2019,219727,204839,70182,494748
Serbia,2020,200567,221404,177515,599486
Serbia,2021,292118,253819,105677,651614
Serbia,2022,334269,267740,99186,701195
Serbia,2023,310707,271138,96412,678257
Serbia,2024,348186,286973,115490,750649
Serbia and Montenegro,2005,133132,114750,28968,276850
Serbia and Montenegro,2006,124332,68248,5689,198269
Serbia and Montenegro,2007,0,0,0,0
Serbia and Montenegro,2008,0,0,0,0
Serbia and Montenegro,2009,0,0,0,0
Serbia and Montenegro,2010,0,0,0,0
Serbia and Montenegro,2011,0,0,0,0
Serbia and Montenegro,2012,0,0,0,0
Serbia and Montenegro,2013,0,0,0,0
Serbia and Montenegro,2014,0,0,0,0
Serbia and Montenegro,2015,0,0,0,0
Serbia and Montenegro,2016,0,0,0,0
Serbia and Montenegro,2017,0,0,0,0
Serbia and Montenegro,2018,0,0,0,0
Serbia and Montenegro,2019,0,0,0,0
Serbia and Montenegro,2020,0,0,0,0
Serbia and Montenegro,2021,0,0,0,0
Serbia and Montenegro,2022,0,0,0,0
Serbia and Montenegro,2023,0,0,0,0
Serbia and Montenegro,2024,0,0,0,0
Seychelles,2005,2133,1467,2680,6280
Seychelles,2006,2954,2386,2716,8056
Seychelles,2007,0,0,0,0
Seychelles,2008,2276,2281,4635,9192
Seychelles,2009,6504,5755,16448,28707
Seychelles,2010,2482,2758,5954,11194
Seychelles,2011,3373,3428,5742,12543
Seychelles,2012,2228,2684,3815,8727
Seychelles,2013,2134,1839,2700,6673
Seychelles,2014,2694,2059,3611,8364
Seychelles,2015,4332,2918,5347,12597
Seychelles,2016,3443,2792,5241,11476
Seychelles,2017,3099,2760,5539,11398
Seychelles,2018,4057,3207,5891,13155
Seychelles,2019,4568,3641,5733,13942
Seychelles,2020,4250,4198,5880,14328
Seychelles,2021,4712,4526,8470,17708
Seychelles,2022,6000,4569,7054,17623
Seychelles,2023,6186,6005,8799,20990
Seychelles,2024,5709,6024,10117,21850
Ship stores and bunkers,2005,696,1667,2527,4890
Ship stores and bunkers,2006,930,2281,2117,5328
Ship stores and bunkers,2007,534,2389,2508,5431
Ship stores and bunkers,2008,645,2693,2392,5730
Ship stores and bunkers,2009,596,1887,1928,4411
Ship stores and bunkers,2010,804,2426,2048,5278
Ship stores and bunkers,2011,1075,3054,1853,5982
Ship stores and bunkers,2012,1406,1895,2057,5358
Ship stores and bunkers,2013,2361,3145,3085,8591
Ship stores and bunkers,2014,2976,5477,2908,11361
Ship stores and bunkers,2015,1888,2258,3047,7193
Ship stores and bunkers,2016,2016,2454,4290,8760
Ship stores and bunkers,2017,3179,3495,3818,10492
Ship stores and bunkers,2018,3907,10754,12713,27374
Ship stores and bunkers,2019,5640,10504,14347,30491
Ship stores and bunkers,2020,2252,4359,7881,14492
Ship stores and bunkers,2021,2841,4104,7137,14082
Ship stores and bunkers,2022,5423,7240,12386,25049
Ship stores and bunkers,2023,3701,5835,8943,18479
Ship stores and bunkers,2024,0,0,0,0
Sierra Leone,2005,0,0,0,0
Sierra Leone,2006,0,0,0,0
Sierra Leone,2007,0,0,0,0
Sierra Leone,2008,0,0,0,0
Sierra Leone,2009,0,0,0,0
Sierra Leone,2010,0,0,0,0
Sierra Leone,2011,0,0,0,0
Sierra Leone,2012,0,0,0,0
Sierra Leone,2013,0,0,0,0
Sierra Leone,2014,2333,3718,30697,36748
Sierra Leone,2015,295,1987,30909,33191
Sierra Leone,2016,441,1795,49179,51415
Sierra Leone,2017,622,1165,21121,22908
Sierra Leone,2018,842,2209,19674,22725
Sierra Leone,2019,4986,4553,15634,25173
Sierra Leone,2020,5279,3448,15344,24071
Sierra Leone,2021,7145,5160,21234,33539
Sierra Leone,2022,6606,8466,16499,31571
Sierra Leone,2023,16822,7216,29601,53639
Sierra Leone,2024,0,0,0,0
Singapore,2005,1267163,780993,164875,2213031
Singapore,2006,1429782,984658,182169,2596609
Singapore,2007,1350291,997922,194936,2543149
Singapore,2008,1233354,893448,217423,2344225
Singapore,2009,899230,697329,199561,1796120
Singapore,2010,1017443,816467,209005,2042915
Singapore,2011,1200320,997713,234908,2432941
Singapore,2012,1229371,1011254,244582,2485207
Singapore,2013,1680126,1090689,277279,3048094
Singapore,2014,1264413,1137440,267289,2669142
Singapore,2015,1286149,982473,253117,2521739
Singapore,2016,1219287,1030757,241970,2492014
Singapore,2017,1255572,1145282,229179,2630033
Singapore,2018,1278752,1178410,230383,2687545
Singapore,2019,1155585,1133984,214655,2504224
Singapore,2020,885531,1156319,1165555,3207405
Singapore,2021,1047868,867286,325960,2241114
Singapore,2022,1220628,1116929,282888,2620445
Singapore,2023,1158513,1133695,250919,2543127
Singapore,2024,1110137,1120885,254998,2486020
Sint Maarten (Dutch part),2005,0,0,0,0
Sint Maarten (Dutch part),2006,0,0,0,0
Sint Maarten (Dutch part),2007,0,0,0,0
Sint Maarten (Dutch part),2008,0,0,0,0
Sint Maarten (Dutch part),2009,0,0,0,0
Sint Maarten (Dutch part),2010,0,0,0,0
Sint Maarten (Dutch part),2011,1634,1267,1513,4414
Sint Maarten (Dutch part),2012,2390,2077,3032,7499
Sint Maarten (Dutch part),2013,2485,2726,5046,10257
Sint Maarten (Dutch part),2014,3286,2824,4513,10623
Sint Maarten (Dutch part),2015,1486,2698,1232,5416
Sint Maarten (Dutch part),2016,1056,1939,1069,4064
Sint Maarten (Dutch part),2017,1105,1142,778,3025
Sint Maarten (Dutch part),2018,892,1327,815,3034
Sint Maarten (Dutch part),2019,1411,1359,1477,4247
Sint Maarten (Dutch part),2020,407,678,1128,2213
Sint Maarten (Dutch part),2021,432,563,1205,2200
Sint Maarten (Dutch part),2022,1200,895,953,3048
Sint Maarten (Dutch part),2023,2036,1865,1183,5084
Sint Maarten (Dutch part),2024,0,0,0,0
Slovakia,2005,229295,155525,77608,462428
Slovakia,2006,273848,217755,78672,570275
Slovakia,2007,382788,337145,105111,825044
Slovakia,2008,458022,366892,133802,958716
Slovakia,2009,525841,458186,133238,1117265
Slovakia,2010,600069,450430,136464,1186963
Slovakia,2011,778001,583816,171697,1533514
Slovakia,2012,655797,527733,130629,1314159
Slovakia,2013,725062,556376,147985,1429423
Slovakia,2014,805679,622862,164281,1592822
Slovakia,2015,714434,550612,133697,1398743
Slovakia,2016,736949,555063,174948,1466960
Slovakia,2017,801665,599549,191989,1593203
Slovakia,2018,904901,633786,211908,1750595
Slovakia,2019,1027985,633349,279529,1940863
Slovakia,2020,798674,612159,326505,1737338
Slovakia,2021,933369,682185,283086,1898640
Slovakia,2022,1078615,773681,287443,2139739
Slovakia,2023,1037642,835995,262833,2136470
Slovakia,2024,1164343,952716,280595,2397654
Slovenia,2005,168390,182450,41945,392785
Slovenia,2006,188880,210684,49623,449187
Slovenia,2007,248336,281342,73637,603315
Slovenia,2008,304109,331466,82111,717686
Slovenia,2009,280753,272882,74702,628337
Slovenia,2010,288680,260014,82119,630813
Slovenia,2011,320078,300261,92117,712456
Slovenia,2012,256771,237902,74103,568776
Slovenia,2013,271100,228316,88812,588228
Slovenia,2014,309737,253209,122681,685627
Slovenia,2015,266908,216181,116932,600021
Slovenia,2016,304951,244605,101078,650634
Slovenia,2017,345784,291113,97040,733937
Slovenia,2018,352437,308947,103512,764896
Slovenia,2019,393455,265999,93959,753413
Slovenia,2020,327618,241640,218108,787366
Slovenia,2021,447490,289674,139871,877035
Slovenia,2022,461282,312246,122491,896019
Slovenia,2023,433872,332716,116472,883060
Slovenia,2024,628730,403482,153748,1185960
Solomon Islands,2005,1196,814,1474,3484
Solomon Islands,2006,1494,725,2059,4278
Solomon Islands,2007,968,1054,2944,4966
Solomon Islands,2008,1218,1126,2298,4642
Solomon Islands,2009,604,409,1944,2957
Solomon Islands,2010,1121,2747,4343,8211
Solomon Islands,2011,1096,1765,4095,6956
Solomon Islands,2012,1545,2258,4750,8553
Solomon Islands,2013,2241,2967,6590,11798
Solomon Islands,2014,1794,1967,5579,9340
Solomon Islands,2015,1387,1236,4172,6795
Solomon Islands,2016,1228,1871,5549,8648
Solomon Islands,2017,1393,2225,5904,9522
Solomon Islands,2018,1703,1996,5806,9505
Solomon Islands,2019,2614,1811,5058,9483
Solomon Islands,2020,1731,2596,4345,8672
Solomon Islands,2021,1653,1905,5330,8888
Solomon Islands,2022,1533,3578,4326,9437
Solomon Islands,2023,2374,2873,6436,11683
Solomon Islands,2024,0,0,0,0
Somalia,2005,3273,20216,4425,27914
Somalia,2006,1151,2833,3902,7886
Somalia,2007,1995,15950,6890,24835
Somalia,2008,2705,10749,4634,18088
Somalia,2009,1593,2783,6567,10943
Somalia,2010,1931,3461,5036,10428
Somalia,2011,1725,2973,11115,15813
Somalia,2012,6198,9799,17310,33307
Somalia,2013,12866,12745,18889,44500
Somalia,2014,11822,12062,18157,42041
Somalia,2015,18817,16628,26729,62174
Somalia,2016,31724,23061,25918,80703
Somalia,2017,42673,28738,35228,106639
Somalia,2018,44426,39159,33748,117333
Somalia,2019,57218,45054,37265,139537
Somalia,2020,48129,57169,39563,144861
Somalia,2021,51080,56319,52804,160203
Somalia,2022,53755,67524,47695,168974
Somalia,2023,66864,77424,46250,190538
Somalia,2024,0,0,0,0
South Africa,2005,313486,438762,109243,861491
South Africa,2006,434969,581020,140482,1156471
South Africa,2007,417036,478776,159535,1055347
South Africa,2008,434350,460634,163689,1058673
South Africa,2009,456740,509900,145193,1111833
South Africa,2010,690453,827664,215812,1733929
South Africa,2011,817870,971447,267286,2056603
South Africa,2012,826940,838008,269917,1934865
South Africa,2013,877993,881711,271315,2031019
South Africa,2014,848933,872860,243621,1965414
South Africa,2015,842209,901797,240266,1984272
South Africa,2016,763062,857822,196390,1817274
South Africa,2017,784927,892480,208980,1886387
South Africa,2018,845878,1012617,260778,2119273
South Africa,2019,863775,998857,246122,2108754
South Africa,2020,696273,796934,673354,2166561
South Africa,2021,960852,944290,270399,2175541
South Africa,2022,1050996,1006869,242637,2300502
South Africa,2023,890553,924373,205314,2020240
South Africa,2024,988282,979069,242403,2209754
South Sudan,2005,0,0,0,0
South Sudan,2006,0,0,0,0
South Sudan,2007,0,0,0,0
South Sudan,2008,0,0,0,0
South Sudan,2009,0,0,0,0
South Sudan,2010,0,0,0,0
South Sudan,2011,0,0,0,0
South Sudan,2012,914,4405,18909,24228
South Sudan,2013,779,4472,17255,22506
South Sudan,2014,2658,3272,30883,36813
South Sudan,2015,1273,1602,13355,16230
South Sudan,2016,1282,2248,16082,19612
South Sudan,2017,1272,1454,13718,16444
South Sudan,2018,17083,4649,6628,28360
South Sudan,2019,24109,9040,7881,41030
South Sudan,2020,14853,12928,20220,48001
South Sudan,2021,67141,28078,12260,107479
South Sudan,2022,111756,23758,19612,155126
South Sudan,2023,182849,12790,11029,206668
South Sudan,2024,0,0,0,0
Spain,2005,4037477,4938884,850728,9827089
Spain,2006,4785602,5775615,944714,11505931
Spain,2007,5833023,6974725,1168698,13976446
Spain,2008,6774032,8055659,1182729,16012420
Spain,2009,5782777,6871731,1093757,13748265
Spain,2010,6230437,7127223,1106465,14464125
Spain,2011,7009761,8097663,1208596,16316020
Spain,2012,6437430,7586007,996170,15019607
Spain,2013,6587154,7877765,1080051,15544970
Spain,2014,7508920,8942190,1266951,17718061
Spain,2015,7002059,8629184,1265929,16897172
Spain,2016,7547013,9330994,1349589,18227596
Spain,2017,7888371,10026310,1399086,19313767
Spain,2018,8430663,10842760,1420433,20693856
Spain,2019,8723178,10732428,1371411,20827017
Spain,2020,7533401,8673908,3530772,19738081
Spain,2021,8927711,9617685,1876748,20422144
Spain,2022,10754982,11574478,1670069,23999529
Spain,2023,9738264,10610347,1443342,21791953
Spain,2024,10799686,11313651,1570135,23683472
Sri Lanka,2005,36813,47089,7538,91440
Sri Lanka,2006,39699,35054,6758,81511
Sri Lanka,2007,45495,34305,6041,85841
Sri Lanka,2008,44919,34922,7878,87719
Sri Lanka,2009,34654,41975,6235,82864
Sri Lanka,2010,40586,47765,6191,94542
Sri Lanka,2011,49523,74140,15204,138867
Sri Lanka,2012,53270,81695,9271,144236
Sri Lanka,2013,42472,107328,9815,159615
Sri Lanka,2014,55230,159740,18707,233677
Sri Lanka,2015,79936,205635,26151,311722
Sri Lanka,2016,82554,203255,33122,318931
Sri Lanka,2017,84822,205305,38373,328500
Sri Lanka,2018,0,0,0,0
Sri Lanka,2019,67635,156006,32006,255647
Sri Lanka,2020,56523,101859,43125,201507
Sri Lanka,2021,74121,113934,40492,228547
Sri Lanka,2022,70239,101505,20145,191889
Sri Lanka,2023,61940,69697,13995,145632
Sri Lanka,2024,74729,109070,18957,202756
Sudan,2005,0,0,0,0
Sudan,2006,0,0,0,0
Sudan,2007,0,0,0,0
Sudan,2008,0,0,0,0
Sudan,2009,0,0,0,0
Sudan,2010,0,0,0,0
Sudan,2011,0,0,0,0
Sudan,2012,966,85527,128215,214708
Sudan,2013,1038,106951,118193,226182
Sudan,2014,1317,137857,158936,298110
Sudan,2015,4410,166339,171384,342133
Sudan,2016,422,157359,146860,304641
Sudan,2017,6449,187255,202724,396428
Sudan,2018,3349,127935,196383,327667
Sudan,2019,228714,357467,92387,678568
Sudan,2020,250784,265802,117194,633780
Sudan,2021,126089,101353,99885,327327
Sudan,2022,176204,131039,137262,444505
Sudan,2023,104362,89935,94811,289108
Sudan,2024,0,0,0,0
Sudan (before 2012),2005,9360,90475,60717,160552
Sudan (before 2012),2006,2674,126473,58112,187259
Sudan (before 2012),2007,9908,144384,88451,242743
Sudan (before 2012),2008,23160,126227,190247,339634
Sudan (before 2012),2009,1112,125093,114910,241115
Sudan (before 2012),2010,83228,153247,120776,357251
Sudan (before 2012),2011,2767,105730,111000,219497
Sudan (before 2012),2012,0,0,0,0
Sudan (before 2012),2013,0,0,0,0
Sudan (before 2012),2014,0,0,0,0
Sudan (before 2012),2015,0,0,0,0
Sudan (before 2012),2016,0,0,0,0
Sudan (before 2012),2017,0,0,0,0
Sudan (before 2012),2018,0,0,0,0
Sudan (before 2012),2019,0,0,0,0
Sudan (before 2012),2020,0,0,0,0
Sudan (before 2012),2021,0,0,0,0
Sudan (before 2012),2022,0,0,0,0
Sudan (before 2012),2023,0,0,0,0
Sudan (before 2012),2024,0,0,0,0
Suriname,2005,3984,9302,4011,17297
Suriname,2006,0,0,0,0
Suriname,2007,3501,9595,3627,16723
Suriname,2008,0,0,0,0
Suriname,2009,4394,8795,4629,17818
Suriname,2010,5199,7454,5171,17824
Suriname,2011,4831,8734,4694,18259
Suriname,2012,5186,11082,12627,28895
Suriname,2013,4529,7542,5008,17079
Suriname,2014,5308,7790,5870,18968
Suriname,2015,2175,9401,6389,17965
Suriname,2016,1306,3764,3876,8946
Suriname,2017,2226,5313,4156,11695
Suriname,2018,2484,5544,4969,12997
Suriname,2019,3150,9161,6440,18751
Suriname,2020,3232,7225,8953,19410
Suriname,2021,2009,6484,6178,14671
Suriname,2022,2611,5700,6736,15047
Suriname,2023,2608,6191,4493,13292
Suriname,2024,0,0,0,0
Sweden,2005,1182101,1449735,415664,3047500
Sweden,2006,1320447,1476860,470066,3267373
Sweden,2007,1542000,1708301,546615,3796916
Sweden,2008,1646538,1847208,549847,4043593
Sweden,2009,1467091,1580222,440955,3488268
Sweden,2010,1662764,1778522,489907,3931193
Sweden,2011,1935550,2197195,626570,4759315
Sweden,2012,1805184,2073554,545681,4424419
Sweden,2013,1950655,2148979,598571,4698205
Sweden,2014,2046677,2241557,627542,4915776
Sweden,2015,1819618,2026897,542542,4389057
Sweden,2016,1915493,2125577,535626,4576696
Sweden,2017,1993239,2208154,577714,4779107
Sweden,2018,2067322,2292993,591731,4952046
Sweden,2019,2145559,2410772,584420,5140751
Sweden,2020,2052144,2238135,728792,5019071
Sweden,2021,2557595,2568407,842834,5968836
Sweden,2022,2713794,2928927,776329,6419050
Sweden,2023,2177440,2425928,586230,5189598
Sweden,2024,2332933,2445457,634405,5412795
Switzerland,2005,1632676,2508982,423981,4565639
Switzerland,2006,1725927,2574966,469043,4769936
Switzerland,2007,1948218,2835866,526637,5310721
Switzerland,2008,2230244,3097424,582388,5910056
Switzerland,2009,2087443,2768155,548399,5403997
Switzerland,2010,2186079,2721439,583209,5490727
Switzerland,2011,2543359,3153883,674552,6371794
Switzerland,2012,2387929,2928453,643291,5959673
Switzerland,2013,2460285,2997836,673160,6131281
Switzerland,2014,2528390,3141718,723667,6393775
Switzerland,2015,2269558,2911086,644984,5825628
Switzerland,2016,2394860,3136742,656824,6188426
Switzerland,2017,2714278,3574340,672249,6960867
Switzerland,2018,3018652,4068809,727302,7814763
Switzerland,2019,3127357,4136070,713456,7976883
Switzerland,2020,3330241,4157537,1646521,9134299
Switzerland,2021,3870023,4423427,990939,9284389
Switzerland,2022,3844783,4317085,884942,9046810
Switzerland,2023,3817740,4560759,843322,9221821
Switzerland,2024,3801209,4566425,866206,9233840
Syrian Arab Republic,2005,421,883,18989,20293
Syrian Arab Republic,2006,2107,5618,30563,38288
Syrian Arab Republic,2007,1694,4147,22199,28040
Syrian Arab Republic,2008,1652,5899,10134,17685
Syrian Arab Republic,2009,6655,17981,8768,33404
Syrian Arab Republic,2010,6134,13765,11114,31013
Syrian Arab Republic,2011,30283,36486,42002,108771
Syrian Arab Republic,2012,21609,15516,15427,52552
Syrian Arab Republic,2013,34625,17130,73995,125750
Syrian Arab Republic,2014,46944,44693,86368,178005
Syrian Arab Republic,2015,52872,42962,59009,154843
Syrian Arab Republic,2016,34153,45156,36482,115791
Syrian Arab Republic,2017,36225,31605,40088,107918
Syrian Arab Republic,2018,38989,24085,32837,95911
Syrian Arab Republic,2019,26387,14204,60411,101002
Syrian Arab Republic,2020,9195,6089,55105,70389
Syrian Arab Republic,2021,4227,4077,24801,33105
Syrian Arab Republic,2022,4424,4561,25986,34971
Syrian Arab Republic,2023,10479,10439,29524,50442
Syrian Arab Republic,2024,0,0,0,0
"Taipei, Chinese",2005,429823,605002,114789,1149614
"Taipei, Chinese",2006,476487,681913,132522,1290922
"Taipei, Chinese",2007,450876,596630,129761,1177267
"Taipei, Chinese",2008,497425,592411,135277,1225113
"Taipei, Chinese",2009,431707,508757,125060,1065524
"Taipei, Chinese",2010,512728,594325,162580,1269633
"Taipei, Chinese",2011,674185,746502,182199,1602886
"Taipei, Chinese",2012,752004,774723,173899,1700626
"Taipei, Chinese",2013,720805,775736,176983,1673524
"Taipei, Chinese",2014,800304,841911,203798,1846013
"Taipei, Chinese",2015,871224,943930,222837,2037991
"Taipei, Chinese",2016,903834,922727,219083,2045644
"Taipei, Chinese",2017,874875,867237,229744,1971856
"Taipei, Chinese",2018,993943,943872,255986,2193801
"Taipei, Chinese",2019,996986,952834,268198,2218018
"Taipei, Chinese",2020,921038,900600,305509,2127147
"Taipei, Chinese",2021,1018997,909162,345536,2273695
"Taipei, Chinese",2022,1113950,1007726,342211,2463887
"Taipei, Chinese",2023,1167068,1044547,299746,2511361
"Taipei, Chinese",2024,1140577,1067105,313913,2521595
Tajikistan,2005,0,0,0,0
Tajikistan,2006,0,0,0,0
Tajikistan,2007,0,0,0,0
Tajikistan,2008,0,0,0,0
Tajikistan,2009,0,0,0,0
Tajikistan,2010,0,0,0,0
Tajikistan,2011,0,0,0,0
Tajikistan,2012,0,0,0,0
Tajikistan,2013,0,0,0,0
Tajikistan,2014,6087,12954,13941,32982
Tajikistan,2015,6166,13663,16771,36600
Tajikistan,2016,6928,13280,22343,42551
Tajikistan,2017,7349,10553,19247,37149
Tajikistan,2018,7407,8357,14419,30183
Tajikistan,2019,7478,14166,18085,39729
Tajikistan,2020,7006,9484,25905,42395
Tajikistan,2021,6211,8306,24057,38574
Tajikistan,2022,10051,9291,30022,49364
Tajikistan,2023,10631,13367,26196,50194
Tajikistan,2024,0,0,0,0
"Tanzania, United Republic of",2005,5880,7512,36146,49538
"Tanzania, United Republic of",2006,5777,11598,39230,56605
"Tanzania, United Republic of",2007,4185,14123,47358,65666
"Tanzania, United Republic of",2008,8849,23466,56772,89087
"Tanzania, United Republic of",2009,7857,22989,57942,88788
"Tanzania, United Republic of",2010,10362,29611,67532,107505
"Tanzania, United Republic of",2011,14448,22837,87670,124955
"Tanzania, United Republic of",2012,18594,20309,95669,134572
"Tanzania, United Republic of",2013,25710,31519,93843,151072
"Tanzania, United Republic of",2014,28924,33097,111206,173227
"Tanzania, United Republic of",2015,20934,31747,109432,162113
"Tanzania, United Republic of",2016,23651,29978,106258,159887
"Tanzania, United Republic of",2017,22848,28227,87683,138758
"Tanzania, United Republic of",2018,27717,27278,123055,178050
"Tanzania, United Republic of",2019,30917,28325,146079,205321
"Tanzania, United Republic of",2020,26448,20996,152740,200184
"Tanzania, United Republic of",2021,37102,24014,148334,209450
"Tanzania, United Republic of",2022,49295,34287,165887,249469
"Tanzania, United Republic of",2023,47682,28630,157988,234300
"Tanzania, United Republic of",2024,0,0,0,0
Thailand,2005,67404,114632,79552,261588
Thailand,2006,89637,149464,83666,322767
Thailand,2007,99507,189945,104271,393723
Thailand,2008,133497,213042,148176,494715
Thailand,2009,121730,206078,155734,483542
Thailand,2010,174062,246077,150360,570499
Thailand,2011,227333,305671,205902,738906
Thailand,2012,271656,366063,340999,978718
Thailand,2013,287359,405129,312694,1005182
Thailand,2014,316374,448813,253197,1018384
Thailand,2015,360292,479099,247149,1086540
Thailand,2016,403937,566587,265644,1236168
Thailand,2017,450803,584421,297528,1332752
Thailand,2018,582208,733420,345086,1660714
Thailand,2019,606861,773324,370725,1750910
Thailand,2020,480887,633952,378437,1493276
Thailand,2021,441379,620283,482469,1544131
Thailand,2022,594255,718780,468674,1781709
Thailand,2023,719719,771398,450138,1941255
Thailand,2024,697690,923844,470966,2092500
Timor-Leste,2005,226,478,591,1295
Timor-Leste,2006,0,0,0,0
Timor-Leste,2007,0,0,0,0
Timor-Leste,2008,0,0,0,0
Timor-Leste,2009,0,0,0,0
Timor-Leste,2010,0,0,0,0
Timor-Leste,2011,0,0,0,0
Timor-Leste,2012,0,0,0,0
Timor-Leste,2013,494,421,32610,33525
Timor-Leste,2014,0,0,0,0
Timor-Leste,2015,0,0,0,0
Timor-Leste,2016,0,0,0,0
Timor-Leste,2017,1040,910,11912,13862
Timor-Leste,2018,1261,781,9152,11194
Timor-Leste,2019,1485,1038,6205,8728
Timor-Leste,2020,1329,1102,8588,11019
Timor-Leste,2021,1376,1293,10115,12784
Timor-Leste,2022,1698,3539,13289,18526
Timor-Leste,2023,2429,3799,10016,16244
Timor-Leste,2024,0,0,0,0
Togo,2005,11105,6775,6356,24236
Togo,2006,0,0,0,0
Togo,2007,22173,7270,11086,40529
Togo,2008,23873,8445,19949,52267
Togo,2009,15948,7385,19702,43035
Togo,2010,7327,4289,25328,36944
Togo,2011,13383,5966,32932,52281
Togo,2012,9960,7143,16576,33679
Togo,2013,11489,7689,19616,38794
Togo,2014,8658,6384,30668,45710
Togo,2015,6505,1972,19606,28083
Togo,2016,7966,7072,22780,37818
Togo,2017,5074,7800,35768,48642
Togo,2018,4720,10614,30369,45703
Togo,2019,6551,14090,33371,54012
Togo,2020,8652,18546,50397,77595
Togo,2021,7865,25539,43046,76450
Togo,2022,7084,19680,50537,77301
Togo,2023,7486,33385,65320,106191
Togo,2024,7538,51484,49335,108357
Tokelau,2005,739,655,53,1447
Tokelau,2006,96,1128,122,1346
Tokelau,2007,478,1693,100,2271
Tokelau,2008,234,386,28,648
Tokelau,2009,26,454,98,578
Tokelau,2010,254,153,6,413
Tokelau,2011,103,79,100,282
Tokelau,2012,0,115,6,121
Tokelau,2013,79,148,160,387
Tokelau,2014,0,62,11,73
Tokelau,2015,44,155,0,199
Tokelau,2016,14,14,16,44
Tokelau,2017,4,2,60,66
Tokelau,2018,11,81,0,92
Tokelau,2019,1,90,1,92
Tokelau,2020,0,30,56,86
Tokelau,2021,0,12,7,19
Tokelau,2022,2,4,21,27
Tokelau,2023,3,0,35,38
Tokelau,2024,0,0,0,0
Tonga,2005,0,0,0,0
Tonga,2006,0,0,0,0
Tonga,2007,0,0,0,0
Tonga,2008,1407,443,358,2208
Tonga,2009,1102,267,417,1786
Tonga,2010,1664,442,499,2605
Tonga,2011,1666,600,675,2941
Tonga,2012,1833,531,535,2899
Tonga,2013,1852,429,456,2737
Tonga,2014,1326,799,1166,3291
Tonga,2015,0,0,0,0
Tonga,2016,0,0,0,0
Tonga,2017,1111,408,913,2432
Tonga,2018,1128,496,686,2310
Tonga,2019,1579,612,880,3071
Tonga,2020,1326,659,1684,3669
Tonga,2021,1971,851,868,3690
Tonga,2022,1965,865,2652,5482
Tonga,2023,2427,973,1164,4564
Tonga,2024,0,0,0,0
Trinidad and Tobago,2005,9006,13111,14653,36770
Trinidad and Tobago,2006,10853,27856,13926,52635
Trinidad and Tobago,2007,11515,18158,17982,47655
Trinidad and Tobago,2008,12823,21488,18388,52699
Trinidad and Tobago,2009,11736,20838,15676,48250
Trinidad and Tobago,2010,10723,18794,15912,45429
Trinidad and Tobago,2011,13077,22308,18478,53863
Trinidad and Tobago,2012,13116,26225,21978,61319
Trinidad and Tobago,2013,15180,29602,23537,68319
Trinidad and Tobago,2014,14972,28942,26455,70369
Trinidad and Tobago,2015,16716,34760,23958,75434
Trinidad and Tobago,2016,16887,37864,23843,78594
Trinidad and Tobago,2017,16323,33197,23046,72566
Trinidad and Tobago,2018,18742,34202,24439,77383
Trinidad and Tobago,2019,21691,36026,23518,81235
Trinidad and Tobago,2020,15800,27022,27497,70319
Trinidad and Tobago,2021,14827,25212,25827,65866
Trinidad and Tobago,2022,21435,36102,31378,88915
Trinidad and Tobago,2023,22210,40202,23646,86058
Trinidad and Tobago,2024,0,0,0,0
Tunisia,2005,144286,416055,64755,625096
Tunisia,2006,156894,384657,72865,614416
Tunisia,2007,160507,471815,87018,719340
Tunisia,2008,142235,479006,100481,721722
Tunisia,2009,114329,402592,103012,619933
Tunisia,2010,119851,397760,114020,631631
Tunisia,2011,146995,384974,125659,657628
Tunisia,2012,123363,308881,129615,561859
Tunisia,2013,116540,331396,137332,585268
Tunisia,2014,116409,344207,148986,609602
Tunisia,2015,95882,297459,136512,529853
Tunisia,2016,106153,299665,138635,544453
Tunisia,2017,131130,306600,130446,568176
Tunisia,2018,126056,302824,123602,552482
Tunisia,2019,122719,265566,108394,496679
Tunisia,2020,102571,224795,129732,457098
Tunisia,2021,117020,261758,104440,483218
Tunisia,2022,137456,273659,104673,515788
Tunisia,2023,148135,270261,104458,522854
Tunisia,2024,0,0,0,0
Turkmenistan,2005,4673,6997,4298,15968
Turkmenistan,2006,5121,23695,6385,35201
Turkmenistan,2007,6460,20761,8363,35584
Turkmenistan,2008,34958,28587,11823,75368
Turkmenistan,2009,8956,14721,14606,38283
Turkmenistan,2010,12671,13852,11451,37974
Turkmenistan,2011,10630,16756,12689,40075
Turkmenistan,2012,17995,27459,15280,60734
Turkmenistan,2013,18197,27058,33165,78420
Turkmenistan,2014,27918,24356,46636,98910
Turkmenistan,2015,29948,24946,44755,99649
Turkmenistan,2016,19036,21497,24822,65355
Turkmenistan,2017,14370,19375,16916,50661
Turkmenistan,2018,8965,7910,12155,29030
Turkmenistan,2019,9595,7080,10703,27378
Turkmenistan,2020,12601,9016,8700,30317
Turkmenistan,2021,13863,14797,8866,37526
Turkmenistan,2022,21558,21518,8412,51488
Turkmenistan,2023,23297,22061,11885,57243
Turkmenistan,2024,0,0,0,0
Turks and Caicos Islands,2005,0,0,0,0
Turks and Caicos Islands,2006,0,0,0,0
Turks and Caicos Islands,2007,0,0,0,0
Turks and Caicos Islands,2008,0,0,0,0
Turks and Caicos Islands,2009,0,0,0,0
Turks and Caicos Islands,2010,0,0,0,0
Turks and Caicos Islands,2011,2231,2286,2788,7305
Turks and Caicos Islands,2012,2241,2718,2708,7667
Turks and Caicos Islands,2013,976,401,1779,3156
Turks and Caicos Islands,2014,1133,197,1629,2959
Turks and Caicos Islands,2015,749,499,1988,3236
Turks and Caicos Islands,2016,1045,399,2845,4289
Turks and Caicos Islands,2017,1074,506,2236,3816
Turks and Caicos Islands,2018,1109,498,2634,4241
Turks and Caicos Islands,2019,1232,697,2720,4649
Turks and Caicos Islands,2020,486,599,1384,2469
Turks and Caicos Islands,2021,1168,1257,2433,4858
Turks and Caicos Islands,2022,1782,916,3183,5881
Turks and Caicos Islands,2023,1882,1411,3870,7163
Turks and Caicos Islands,2024,0,0,0,0
Tuvalu,2005,57,106,28,191
Tuvalu,2006,35,52,24,111
Tuvalu,2007,32,84,136,252
Tuvalu,2008,91,98,209,398
Tuvalu,2009,14,67,60,141
Tuvalu,2010,24,44,27,95
Tuvalu,2011,1703,111,85,1899
Tuvalu,2012,2521,38,103,2662
Tuvalu,2013,129,41,34,204
Tuvalu,2014,29,342,139,510
Tuvalu,2015,319,899,333,1551
Tuvalu,2016,108,56,28,192
Tuvalu,2017,174,82,90,346
Tuvalu,2018,214,14,116,344
Tuvalu,2019,138,81,301,520
Tuvalu,2020,154,208,398,760
Tuvalu,2021,166,173,256,595
Tuvalu,2022,405,572,233,1210
Tuvalu,2023,88,239,328,655
Tuvalu,2024,0,0,0,0
Türkiye,2005,252711,433390,65044,751145
Türkiye,2006,374778,579701,85494,1039973
Türkiye,2007,539045,857974,123552,1520571
Türkiye,2008,761127,1230924,130475,2122526
Türkiye,2009,752858,1157344,110793,2020995
Türkiye,2010,1007371,1550023,146877,2704271
Türkiye,2011,1084866,1874030,206780,3165676
Türkiye,2012,843388,1497894,161191,2502473
Türkiye,2013,891582,1702134,221365,2815081
Türkiye,2014,929341,1700279,257908,2887528
Türkiye,2015,859747,1790830,196353,2846930
Türkiye,2016,789677,1693895,207135,2690707
Türkiye,2017,735652,1342511,185329,2263492
Türkiye,2018,621304,1068925,162366,1852595
Türkiye,2019,617542,914314,181574,1713430
Türkiye,2020,543960,749035,220649,1513644
Türkiye,2021,692468,807894,237957,1738319
Türkiye,2022,1079246,1295908,238982,2614136
Türkiye,2023,1288839,1667838,258388,3215065
Türkiye,2024,1704936,1993108,259106,3957150
Uganda,2005,5496,16817,42203,64516
Uganda,2006,8895,19699,49506,78100
Uganda,2007,18901,24613,61025,104539
Uganda,2008,17952,31858,62350,112160
Uganda,2009,12800,25714,59095,97609
Uganda,2010,15757,23935,98205,137897
Uganda,2011,12935,25453,70566,108954
Uganda,2012,12185,24389,83149,119723
Uganda,2013,14322,22925,130809,168056
Uganda,2014,13369,23200,131088,167657
Uganda,2015,10137,21224,111569,142930
Uganda,2016,12794,22197,147497,182488
Uganda,2017,15405,27064,121409,163878
Uganda,2018,20513,35777,121498,177788
Uganda,2019,22058,35234,126249,183541
Uganda,2020,20938,36556,176963,234457
Uganda,2021,27688,35599,141148,204435
Uganda,2022,26510,35035,167378,228923
Uganda,2023,51236,27877,207930,287043
Uganda,2024,0,0,0,0
Ukraine,2005,155934,209620,94400,459954
Ukraine,2006,154834,159517,103911,418262
Ukraine,2007,166868,171387,102877,441132
Ukraine,2008,343484,451437,163781,958702
Ukraine,2009,214839,223722,119643,558204
Ukraine,2010,388424,295602,200418,884444
Ukraine,2011,273624,254370,230153,758147
Ukraine,2012,454638,616413,254612,1325663
Ukraine,2013,380801,510382,272838,1164021
Ukraine,2014,254291,293135,221415,768841
Ukraine,2015,159377,178939,158072,496388
Ukraine,2016,160724,176742,203367,540833
Ukraine,2017,185980,187919,236796,610695
Ukraine,2018,260658,242132,270110,772900
Ukraine,2019,398653,370320,354968,1123941
Ukraine,2020,358557,349154,367241,1074952
Ukraine,2021,461946,401463,356301,1219710
Ukraine,2022,401634,698457,290037,1390128
Ukraine,2023,423886,391825,337675,1153386
Ukraine,2024,463912,380824,347590,1192326
United Arab Emirates,2005,583871,847493,257534,1688898
United Arab Emirates,2006,0,0,0,0
United Arab Emirates,2007,925303,1236416,334709,2496428
United Arab Emirates,2008,1087103,1530172,407531,3024806
United Arab Emirates,2009,0,0,0,0
United Arab Emirates,2010,0,0,0,0
United Arab Emirates,2011,0,0,0,0
United Arab Emirates,2012,2561413,2392038,604271,5557722
United Arab Emirates,2013,1927314,1733829,423660,4084803
United Arab Emirates,2014,2158015,1976127,511626,4645768
United Arab Emirates,2015,2107270,1986554,438812,4532636
United Arab Emirates,2016,1825250,1741191,422887,3989328
United Arab Emirates,2017,2770783,2472256,560400,5803439
United Arab Emirates,2018,2431324,2172982,530673,5134979
United Arab Emirates,2019,2344324,2094608,586067,5024999
United Arab Emirates,2020,1868597,1648818,800833,4318248
United Arab Emirates,2021,2720196,2190266,701155,5611617
United Arab Emirates,2022,3377297,2831674,754639,6963610
United Arab Emirates,2023,3461012,3145699,811975,7418686
United Arab Emirates,2024,0,0,0,0
United Kingdom,2005,10843587,12480036,1968644,25292267
United Kingdom,2006,11544506,13186132,2242564,26973202
United Kingdom,2007,12764769,14447694,2497146,29709609
United Kingdom,2008,13076874,14324246,2478858,29879978
United Kingdom,2009,11925679,12755858,2201718,26883255
United Kingdom,2010,12654778,12504612,2368290,27527680
United Kingdom,2011,13844268,14154250,2512509,30511027
United Kingdom,2012,11958431,11796526,2174080,25929037
United Kingdom,2013,12830510,12192893,2322114,27345517
United Kingdom,2014,14045357,13507497,2623221,30176075
United Kingdom,2015,13395654,13134538,2554047,29084239
United Kingdom,2016,12434889,12081878,2368236,26885003
United Kingdom,2017,12504993,11730327,2412144,26647464
United Kingdom,2018,13048094,11959083,2469187,27476364
United Kingdom,2019,13018418,11887651,2602019,27508088
United Kingdom,2020,11021271,11777995,7088173,29887439
United Kingdom,2021,12078169,8955593,3157929,24191691
United Kingdom,2022,13780660,10585280,3027571,27393511
United Kingdom,2023,11184452,9093466,2610138,22888056
United Kingdom,2024,11014558,8680888,2617590,22313036
United States Minor Outlying Islands,2005,6495,10908,1167,18570
United States Minor Outlying Islands,2006,6754,9898,1392,18044
United States Minor Outlying Islands,2007,5767,8916,1486,16169
United States Minor Outlying Islands,2008,5218,7214,1641,14073
United States Minor Outlying Islands,2009,5485,7358,1016,13859
United States Minor Outlying Islands,2010,8571,9481,1136,19188
United States Minor Outlying Islands,2011,8327,11061,1514,20902
United States Minor Outlying Islands,2012,9081,11107,1348,21536
United States Minor Outlying Islands,2013,6819,11617,1229,19665
United States Minor Outlying Islands,2014,6529,10624,2340,19493
United States Minor Outlying Islands,2015,5065,7619,2399,15083
United States Minor Outlying Islands,2016,4276,7403,3596,15275
United States Minor Outlying Islands,2017,3619,6491,1931,12041
United States Minor Outlying Islands,2018,5272,8229,1845,15346
United States Minor Outlying Islands,2019,7594,8925,2622,19141
United States Minor Outlying Islands,2020,2357,3663,2540,8560
United States Minor Outlying Islands,2021,1244,1799,1279,4322
United States Minor Outlying Islands,2022,2070,3500,933,6503
United States Minor Outlying Islands,2023,16557,22652,1782,40991
United States Minor Outlying Islands,2024,0,0,0,0
United States of America,2005,34850598,39308173,9703184,83861955
United States of America,2006,37199805,39680699,10628884,87509388
United States of America,2007,39650951,39269256,11229657,90149864
United States of America,2008,39028121,37335435,11010309,87373865
United States of America,2009,34668152,32127205,9908282,76703639
United States of America,2010,39949253,35696560,11856454,87502267
United States of America,2011,43285857,38246891,12464556,93997304
United States of America,2012,42598146,38089455,12712647,93400248
United States of America,2013,44423860,39319973,13405321,97149154
United States of America,2014,46627468,39099513,13901702,99628683
United States of America,2015,48514242,40574266,14883555,103972063
United States of America,2016,45417624,38551531,14603419,98572574
United States of America,2017,45745754,37804711,15338411,98888876
United States of America,2018,47681654,39014939,16137772,102834365
United States of America,2019,48160270,39224194,16743414,104127878
United States of America,2020,38254141,32911543,31248825,102414509
United States of America,2021,52249668,35037691,22017576,109304935
United States of America,2022,60784841,44567971,20880022,126232834
United States of America,2023,45244512,36346897,16829265,98420674
United States of America,2024,47374919,36334605,18091260,101800784
Uruguay,2005,26042,23367,16512,65921
Uruguay,2006,33322,29357,21074,83753
Uruguay,2007,45232,39205,23033,107470
Uruguay,2008,64943,59490,29669,154102
Uruguay,2009,66523,55622,28715,150860
Uruguay,2010,90778,70780,40489,202047
Uruguay,2011,117625,98273,51358,267256
Uruguay,2012,124503,107486,52043,284032
Uruguay,2013,131948,118344,46657,296949
Uruguay,2014,133293,112989,47943,294225
Uruguay,2015,131660,113086,43140,287886
Uruguay,2016,119701,100473,38862,259036
Uruguay,2017,138517,125042,45069,308628
Uruguay,2018,149647,133970,38957,322574
Uruguay,2019,136541,117509,37018,291068
Uruguay,2020,108496,86486,39206,234188
Uruguay,2021,130056,103891,49281,283228
Uruguay,2022,178874,124722,52443,356039
Uruguay,2023,171674,133567,47807,353048
Uruguay,2024,177872,138184,54871,370927
Uzbekistan,2005,0,0,0,0
Uzbekistan,2006,0,0,0,0
Uzbekistan,2007,0,0,0,0
Uzbekistan,2008,0,0,0,0
Uzbekistan,2009,0,0,0,0
Uzbekistan,2010,0,0,0,0
Uzbekistan,2011,0,0,0,0
Uzbekistan,2012,0,0,0,0
Uzbekistan,2013,0,0,0,0
Uzbekistan,2014,0,0,0,0
Uzbekistan,2015,0,0,0,0
Uzbekistan,2016,0,0,0,0
Uzbekistan,2017,13286,7656,3749,24691
Uzbekistan,2018,22525,12364,4419,39308
Uzbekistan,2019,29260,16636,9071,54967
Uzbekistan,2020,17927,15005,14277,47209
Uzbekistan,2021,25259,16876,11360,53495
Uzbekistan,2022,36294,24798,14519,75611
Uzbekistan,2023,39239,32476,20670,92385
Uzbekistan,2024,90542,91652,47728,229922
Vanuatu,2005,0,0,0,0
Vanuatu,2006,1107,1085,1344,3536
Vanuatu,2007,1354,1275,1419,4048
Vanuatu,2008,0,0,0,0
Vanuatu,2009,1770,1365,1561,4696
Vanuatu,2010,1730,1696,1578,5004
Vanuatu,2011,2501,1757,2179,6437
Vanuatu,2012,3611,1978,1622,7211
Vanuatu,2013,2803,2204,1740,6747
Vanuatu,2014,1612,1834,1222,4668
Vanuatu,2015,2741,3335,2769,8845
Vanuatu,2016,2759,4801,2866,10426
Vanuatu,2017,2774,2230,2363,7367
Vanuatu,2018,3487,2916,1863,8266
Vanuatu,2019,4888,2294,1861,9043
Vanuatu,2020,3032,1731,2469,7232
Vanuatu,2021,3029,1925,1930,6884
Vanuatu,2022,3620,2117,3029,8766
Vanuatu,2023,4224,3161,3713,11098
Vanuatu,2024,0,0,0,0
"Venezuela, Bolivarian Republic of",2005,285624,213823,98844,598291
"Venezuela, Bolivarian Republic of",2006,288573,201408,116296,606277
"Venezuela, Bolivarian Republic of",2007,831660,596462,210019,1638141
"Venezuela, Bolivarian Republic of",2008,949282,613654,257496,1820432
"Venezuela, Bolivarian Republic of",2009,460460,314661,123187,898308
"Venezuela, Bolivarian Republic of",2010,306535,243339,78742,628616
"Venezuela, Bolivarian Republic of",2011,406846,325908,106193,838947
"Venezuela, Bolivarian Republic of",2012,532151,432879,141153,1106183
"Venezuela, Bolivarian Republic of",2013,346543,317723,94855,759121
"Venezuela, Bolivarian Republic of",2014,383273,365576,102557,851406
"Venezuela, Bolivarian Republic of",2015,147122,251607,71604,470333
"Venezuela, Bolivarian Republic of",2016,93768,129415,21764,244947
"Venezuela, Bolivarian Republic of",2017,52564,93967,28163,174694
"Venezuela, Bolivarian Republic of",2018,47186,54449,17835,119470
"Venezuela, Bolivarian Republic of",2019,71065,116896,25089,213050
"Venezuela, Bolivarian Republic of",2020,64779,78417,46075,189271
"Venezuela, Bolivarian Republic of",2021,115031,169944,53191,338166
"Venezuela, Bolivarian Republic of",2022,181744,268338,87470,537552
"Venezuela, Bolivarian Republic of",2023,213112,269391,85182,567685
"Venezuela, Bolivarian Republic of",2024,0,0,0,0
Viet Nam,2005,58768,201071,7211,267050
Viet Nam,2006,22447,146906,8853,178206
Viet Nam,2007,30279,123281,12400,165960
Viet Nam,2008,52348,160027,15103,227478
Viet Nam,2009,83747,120052,27375,231174
Viet Nam,2010,145116,144006,25907,315029
Viet Nam,2011,177223,159384,42255,378862
Viet Nam,2012,224574,164091,37996,426661
Viet Nam,2013,259055,187351,43880,490286
Viet Nam,2014,273334,206376,56885,536595
Viet Nam,2015,277780,210417,64359,552556
Viet Nam,2016,308205,231735,84846,624786
Viet Nam,2017,284747,233767,110551,629065
Viet Nam,2018,231069,256356,109168,596593
Viet Nam,2019,223620,268714,154797,647131
Viet Nam,2020,245264,218911,202175,666350
Viet Nam,2021,250577,241566,222045,714188
Viet Nam,2022,357812,282637,232702,873151
Viet Nam,2023,308825,300194,207142,816161
Viet Nam,2024,0,0,0,0
Wallis and Futuna Islands,2005,373,661,322,1356
Wallis and Futuna Islands,2006,564,723,425,1712
Wallis and Futuna Islands,2007,504,749,102,1355
Wallis and Futuna Islands,2008,635,985,264,1884
Wallis and Futuna Islands,2009,232,577,177,986
Wallis and Futuna Islands,2010,506,599,166,1271
Wallis and Futuna Islands,2011,429,702,250,1381
Wallis and Futuna Islands,2012,411,921,207,1539
Wallis and Futuna Islands,2013,363,1046,452,1861
Wallis and Futuna Islands,2014,510,1480,260,2250
Wallis and Futuna Islands,2015,824,1164,520,2508
Wallis and Futuna Islands,2016,479,936,181,1596
Wallis and Futuna Islands,2017,154,1116,137,1407
Wallis and Futuna Islands,2018,144,1444,207,1795
Wallis and Futuna Islands,2019,298,1546,285,2129
Wallis and Futuna Islands,2020,157,771,359,1287
Wallis and Futuna Islands,2021,265,1068,305,1638
Wallis and Futuna Islands,2022,505,1135,248,1888
Wallis and Futuna Islands,2023,858,475,231,1564
Wallis and Futuna Islands,2024,0,0,0,0
West Asia not elsewhere specified,2005,0,0,0,0
West Asia not elsewhere specified,2006,0,0,0,0
West Asia not elsewhere specified,2007,0,0,0,0
West Asia not elsewhere specified,2008,0,0,0,0
West Asia not elsewhere specified,2009,0,0,0,0
West Asia not elsewhere specified,2010,0,0,0,0
West Asia not elsewhere specified,2011,0,0,0,0
West Asia not elsewhere specified,2012,0,0,0,0
West Asia not elsewhere specified,2013,0,0,0,0
West Asia not elsewhere specified,2014,0,0,0,0
West Asia not elsewhere specified,2015,0,0,0,0
West Asia not elsewhere specified,2016,0,0,0,0
West Asia not elsewhere specified,2017,0,0,0,0
West Asia not elsewhere specified,2018,0,0,0,0
West Asia not elsewhere specified,2019,0,0,0,0
West Asia not elsewhere specified,2020,0,0,0,0
West Asia not elsewhere specified,2021,0,0,0,0
West Asia not elsewhere specified,2022,9,13,0,22
West Asia not elsewhere specified,2023,18,39,0,57
West Asia not elsewhere specified,2024,0,0,0,0
Western Sahara,2005,0,1,26,27
Western Sahara,2006,0,2,27,29
Western Sahara,2007,5,1,185,191
Western Sahara,2008,4,0,15,19
Western Sahara,2009,124,1,4,129
Western Sahara,2010,114,1,0,115
Western Sahara,2011,0,3,8,11
Western Sahara,2012,1,0,0,1
Western Sahara,2013,3,171,4,178
Western Sahara,2014,3,0,0,3
Western Sahara,2015,20,713,16,749
Western Sahara,2016,4,0,5,9
Western Sahara,2017,0,2,0,2
Western Sahara,2018,0,3,4,7
Western Sahara,2019,2,0,33,35
Western Sahara,2020,127,73,46,246
Western Sahara,2021,0,0,1,1
Western Sahara,2022,0,315,1,316
Western Sahara,2023,7,12,28,47
Western Sahara,2024,0,0,0,0
World,2005,126874899,148661473,32146150,307682522
World,2006,139508067,159791382,36130534,335429983
World,2007,154972428,172068286,40015737,367056451
World,2008,168663761,184205681,43784941,396654383
World,2009,153860538,162574248,40887813,357322599
World,2010,169538868,172703134,45247167,387489169
World,2011,192619762,200020971,51921924,444562657
World,2012,183250548,192028041,50494616,425773205
World,2013,192394800,198469495,52757846,443622141
World,2014,201945994,205583665,55952997,463482656
World,2015,192782996,197258741,53823454,443865191
World,2016,190717064,192676313,53627542,437020919
World,2017,200600022,198733902,56870382,456204306
World,2018,215090949,213146781,60546537,488784267
World,2019,215764983,212911327,61648538,490324848
World,2020,187366287,189051564,123314011,499731862
World,2021,233005979,201679246,82539233,517224458
World,2022,263843105,229357995,78677844,571878944
World,2023,231613364,215598558,67065727,514277649
World,2024,0,0,0,0
Yemen,2005,1481,30154,10730,42365
Yemen,2006,1766,34294,10603,46663
Yemen,2007,6447,50323,21555,78325
Yemen,2008,6999,46335,30119,83453
Yemen,2009,4254,50156,21063,75473
Yemen,2010,3726,41449,19223,64398
Yemen,2011,3533,38233,16489,58255
Yemen,2012,5524,77051,25564,108139
Yemen,2013,4767,85150,30604,120521
Yemen,2014,6900,132589,49198,188687
Yemen,2015,3965,60972,32028,96965
Yemen,2016,184778,103444,54252,342474
Yemen,2017,175959,133909,45347,355215
Yemen,2018,202240,157440,63605,423285
Yemen,2019,302326,248436,66904,617666
Yemen,2020,250074,182946,92683,525703
Yemen,2021,225230,110318,74793,410341
Yemen,2022,285843,138262,65501,489606
Yemen,2023,229836,132863,66518,429217
Yemen,2024,0,0,0,0
Zambia,2005,6836,9995,24256,41087
Zambia,2006,6298,7685,28113,42096
Zambia,2007,8221,8265,34826,51312
Zambia,2008,9949,8680,26268,44897
Zambia,2009,10464,8231,30984,49679
Zambia,2010,13410,10055,36900,60365
Zambia,2011,16249,15434,59339,91022
Zambia,2012,16952,16193,61417,94562
Zambia,2013,31027,23134,70797,124958
Zambia,2014,27885,19306,64593,111784
Zambia,2015,30795,23791,40831,95417
Zambia,2016,23868,15061,34107,73036
Zambia,2017,26142,17008,63846,106996
Zambia,2018,28429,20808,54915,104152
Zambia,2019,29037,35196,53300,117533
Zambia,2020,18572,43321,98310,160203
Zambia,2021,23671,24313,68853,116837
Zambia,2022,22318,29194,96506,148018
Zambia,2023,25302,21131,119552,165985
Zambia,2024,28663,21646,48642,98951
Zimbabwe,2005,1088,1232,11085,13405
Zimbabwe,2006,771,1288,11783,13842
Zimbabwe,2007,3390,4515,17929,25834
Zimbabwe,2008,457,2014,7709,10180
Zimbabwe,2009,2088,3423,9812,15323
Zimbabwe,2010,5763,7534,23333,36630
Zimbabwe,2011,7747,10653,29818,48218
Zimbabwe,2012,9680,10529,27330,47539
Zimbabwe,2013,15236,19259,26754,61249
Zimbabwe,2014,12545,11432,26585,50562
Zimbabwe,2015,10804,9456,23879,44139
Zimbabwe,2016,8093,6482,20480,35055
Zimbabwe,2017,5975,5664,22575,34214
Zimbabwe,2018,7944,9081,26185,43210
Zimbabwe,2019,2715,4996,29175,36886
Zimbabwe,2020,2375,7498,40903,50776
Zimbabwe,2021,3092,11596,39317,54005
Zimbabwe,2022,3837,23107,28542,55486
Zimbabwe,2023,5875,8371,26816,41062
Zimbabwe,2024,0,0,0,0